date,VIVO,OPPO,3,6,7,Downloads
2020/1/1,225382,932215,1350351,13764674,113164,16385786
2020/1/2,88042,754033,1054167,3138764,112795,5147801
2020/1/3,307445,434971,900901,2500781,113684,4257782
2020/1/4,139890,643464,745023,2232562,84236,3845175
2020/1/5,183350,783722,1243683,13200267,107230,15518252
2020/1/6,520542,592622,890943,3235884,109796,5349787
2020/1/7,336091,442923,772950,2318902,77684,3948550
2020/1/8,60914,522285,562702,11742813,110236,12998950
2020/1/9,82275,10261953,694141,12026049,109891,23174309
2020/1/10,450585,14633606,1605945,23936597,108532,40735265
2020/1/11,858920,5808171,1603947,28375210,106583,36752831
2020/1/12,846501,1991492,2252779,113785556,108843,118985171
2020/1/13,731900,1478764,1737150,4516304,108740,8572858
2020/1/14,648865,1099455,1180872,15641928,108190,18679310
2020/1/15,46604,1228283,1173198,7388968,98520,9935573
2020/1/16,61570,956557,996844,6235410,109763,8360144
2020/1/17,823433,2293592,1025113,7847229,113017,12102384
2020/1/18,838789,14133877,1660180,32331436,108029,49072311
2020/1/19,837367,0,2129917,13998332,110062,17075678
2020/1/20,821570,18176382,1386723,27993019,110201,48487895
2020/1/21,20553,1721792,1484075,108057500,108365,111392285
2020/1/22,11021,1364066,1705194,6401019,108455,9589755
2020/1/23,22525,1317359,1894257,5565762,107250,8907153
2020/1/24,70612,1457258,1936680,6431595,93053,9989198
2020/1/25,358451,1536283,2489031,6916562,90572,11390899
2020/1/26,1106762,1356420,1506253,5234985,84047,9288467
2020/1/27,988163,1207590,1875487,6014232,106975,10192447
2020/1/28,871222,1064399,2330489,35547793,97459,39911362
2020/1/29,813962,995515,1966457,16151105,124015,20051054
2020/1/30,769696,941697,2238596,14971819,106792,19028600
2020/1/31,738827,905555,1746651,4338071,131461,7860565
2020/2/1,713469,873136,2052743,5205070,123810,8968228
2020/2/2,699829,552824,1700910,4090800,107040,7151403
2020/2/3,681369,1025506,1678583,4124080,108373,7617911
2020/2/4,674898,775946,1966070,4904224,113260,8434398
2020/2/5,656403,756655,1548252,24001724,112252,27075286
2020/2/6,649662,747928,1104097,3509070,110057,6120814
2020/2/7,643645,753084,1128601,3167098,110009,5802437
2020/2/8,644789,500341,1327781,3771700,92104,6336715
2020/2/9,682821,1091818,1229132,4003628,106870,7114269
2020/2/10,645221,818364,1403802,3826682,106737,6800806
2020/2/11,9308,818181,582562,2370535,76790,3857376
2020/2/12,659510,820845,669033,3073826,110162,5333376
2020/2/13,649504,806313,661023,2999791,112566,5229197
2020/2/14,642179,488713,879186,2896711,112796,5019585
2020/2/15,8439,1177952,830453,2670972,108286,4796102
2020/2/16,666007,814485,883204,3562391,108787,6034874
2020/2/17,637437,791648,723471,3028851,101332,5282739
2020/2/18,631545,787612,862237,3089745,107445,5478584
2020/2/19,7811,2668795,700606,4219810,80095,7677117
2020/2/20,640606,21486400,813174,26690282,107991,49738453
2020/2/21,635938,9877118,2182391,124986242,107203,137788892
2020/2/22,41100,1934548,2363440,12269617,108968,16717673
2020/2/23,13670,1615416,2288674,7856588,108173,11882521
2020/2/24,674591,1243998,1813912,7961579,106804,11800884
2020/2/25,5328,1148435,1525901,5209164,108696,7997524
2020/2/26,3158,1133455,1478553,4681738,109883,7406787
2020/2/27,674475,946540,1413013,4829520,110001,7973549
2020/2/28,670563,597372,1452830,4388258,109950,7218973
2020/2/29,687810,1590414,1629488,5058710,109856,9076278
2020/3/1,14704,596351,2271185,104799426,110529,107792195
2020/3/2,699466,1562816,1275354,5015577,109553,8662766
2020/3/3,670593,1038502,915235,3988669,109468,6722467
2020/3/4,672856,1021358,0,2973757,109899,4777870
2020/3/5,664554,837674,286377,3009131,109523,4907259
2020/3/6,664747,536953,2641354,5027903,107287,8978244
2020/3/7,26945,1468915,758453,3091886,79029,5425228
2020/3/8,11556,1012727,1045887,2886136,62316,5018622
2020/3/9,695526,995360,1031318,4637820,93273,7453297
2020/3/10,672000,962999,880916,3269118,107326,5892359
2020/3/11,668062,897527,751111,12265713,108506,14690919
2020/3/12,669129,1018905,844076,3581987,108787,6222884
2020/3/13,665810,946366,953789,3620290,108730,6294985
2020/3/14,689147,954455,1000563,3702435,75546,6422146
2020/3/15,705787,963250,1073964,3457614,98190,6298805
2020/3/16,685489,8968027,1262357,12255201,106888,23277962
2020/3/17,658615,18266408,1791919,25752703,108164,46577809
2020/3/18,655956,6999790,1559559,119779089,100329,129094723
2020/3/19,643975,2085029,1445881,10504685,108196,14787766
2020/3/20,637935,1462811,1254986,6406506,92683,9854921
2020/3/21,658918,1573010,1032512,4936402,93837,8294679
2020/3/22,688071,1293461,1226670,5800392,109034,9117628
2020/3/23,665725,903356,880239,4185441,108675,6743436
2020/3/24,631627,1143995,756208,4145562,98092,6775484
2020/3/25,635098,1118793,783771,3489224,107448,6134334
2020/3/26,636563,1094189,746063,4337792,107107,6921714
2020/3/27,628883,1068026,730925,3741241,99662,6268737
2020/3/28,650761,1084035,721696,3315927,108677,5881096
2020/3/29,0,1096633,971611,3362184,108555,5538983
2020/3/30,0,1040261,679556,3354606,108277,5182700
2020/3/31,620100,9760797,727590,12385115,108409,23602011
2020/4/1,2730797,11820498,392833,26714304,98116,41756548
2020/4/2,1170055,3798741,303300,105988289,107285,111367670
2020/4/3,706755,1376527,219353,3617896,108146,6028677
2020/4/4,748082,1373794,197766,2989086,96504,5405232
2020/4/5,686523,1256080,232941,3219059,92721,5487324
2020/4/6,768698,1158240,233102,2885331,107188,5152559
2020/4/7,630957,659117,180753,2025175,72946,3568948
2020/4/8,584699,885984,156192,2100413,97823,3825111
2020/4/9,569908,865607,150091,2034272,109490,3729368
2020/4/10,0,480321,146407,1053166,110130,1790024
2020/4/11,0,2869017,148193,3468025,108479,6593714
2020/4/12,0,1005138,166846,1643532,90118,2905634
2020/4/13,0,31302,147132,612891,107530,898855
2020/4/14,2959175,1664481,129698,5179359,107019,10039732
2020/4/15,531495,780442,113634,1823232,102733,3351536
2020/4/16,525873,770974,77823,1594087,86453,3055210
2020/4/17,532099,8893479,244832,10215695,44687,19930792
2020/4/18,595140,16970564,1020134,20371587,50510,39007935
2020/4/19,684193,6669214,1191557,15887864,42924,24475752
2020/4/20,625894,1905807,1061287,6540296,50336,10183620
2020/4/21,512252,992016,931950,4165561,89444,6691223
2020/4/22,495721,756862,786032,3281905,82764,5403284
2020/4/23,478049,1258476,627165,3414151,108850,5886691
2020/4/24,476354,975682,621401,2989295,108046,5170778
2020/4/25,570398,543464,698455,2736460,107373,4656150
2020/4/26,617309,996750,785171,3359206,109020,5867456
2020/4/27,481475,1220477,552269,3030078,108525,5392824
2020/4/28,446495,1044626,443019,2646879,91050,4672069
2020/4/29,442992,1012708,420785,2561741,110284,4548510
2020/4/30,489849,1041346,397199,2608482,97560,4634436
2020/5/1,834046,1310964,323759,3432922,107469,6009160
2020/5/2,1057030,1504908,397433,3442193,109748,6511312
2020/5/3,816216,1489065,349295,3006341,112758,5773675
2020/5/4,712860,1152755,277154,13141827,109332,15393928
2020/5/5,628523,1017424,263701,2638442,107119,4655209
2020/5/6,582246,930590,210220,1972174,107271,3802501
2020/5/7,450648,806581,141999,1971739,108924,3479891
2020/5/8,434883,702238,165167,11660490,51400,13014178
2020/5/9,466276,730496,168416,1749942,76154,3191284
2020/5/10,606583,856714,218549,2120025,90820,3892691
2020/5/11,639015,930644,136297,12137211,56822,13899989
2020/5/12,393864,782541,146787,1627506,107093,3057791
2020/5/13,382153,608227,124160,1404230,85899,2604669
2020/5/14,385358,596947,134614,1405279,75039,2597237
2020/5/15,399922,1118615,151825,1841349,62151,3573862
2020/5/16,585036,219257,172596,11469133,61070,12507092
2020/5/17,799969,1014873,161350,2447073,57679,4480944
2020/5/18,655938,1091419,125179,2267139,58690,4198365
2020/5/19,384279,807437,106715,1559644,48409,2906484
2020/5/20,374579,628986,97362,11362473,84040,12547440
2020/5/21,391393,626659,69411,1363749,90927,2542139
2020/5/22,399042,626954,130728,1433395,91176,2681295
2020/5/23,576891,754150,172529,1715783,78713,3298066
2020/5/24,808488,1041268,161965,2427233,78978,4517932
2020/5/25,664285,1022851,102943,12377581,74852,14242512
2020/5/26,367508,726835,76714,1420009,89440,2680506
2020/5/27,348052,533270,78466,101197578,78668,102236034
2020/5/28,341870,538861,80981,1200259,90647,2252618
2020/5/29,352318,543533,71570,1210515,76403,2254339
2020/5/30,571925,692047,153375,1762068,75724,3255139
2020/5/31,853062,974115,121743,2426525,63665,4439110
2020/6/1,688941,993439,73070,2137240,45602,3938292
2020/6/2,388258,1078017,66393,11786428,95447,13414543
2020/6/3,340945,177240,57162,719426,108869,1403642
2020/6/4,332505,473084,70009,1109379,108648,2093625
2020/6/5,334438,473002,66687,1105695,108981,2088803
2020/6/6,537768,627219,144579,1630905,109043,3049514
2020/6/7,827468,944935,121897,12342333,108517,14345150
2020/6/8,673803,991888,73414,2108897,108040,3956042
2020/6/9,316607,654305,60450,1253350,95312,2380024
2020/6/10,311267,444083,51900,1027431,107089,1941770
2020/6/11,318456,446355,60998,1048581,108103,1982493
2020/6/12,329337,756982,70257,9320774,108483,10585833
2020/6/13,551973,579890,121656,1572270,108227,2934016
2020/6/14,864081,1064368,93007,2471824,90803,4584083
2020/6/15,703775,1066343,39961,2182290,78301,4070670
2020/6/16,322169,601932,29840,11164918,74881,12193740
2020/6/17,314752,1021244,71125,1621354,110082,3138557
2020/6/18,361420,8642263,730794,11337721,109831,21182029
2020/6/19,374218,624272,692792,7159416,109560,8960258
2020/6/20,572877,1699194,565428,115968478,100170,118906147
2020/6/21,875122,1896944,669592,5927151,109338,9478147
2020/6/22,730577,895620,616886,4541034,109558,6893675
2020/6/23,391025,598828,332182,2343001,110303,3775339
2020/6/24,385991,830542,358694,2139156,110437,3824820
2020/6/25,765536,1440283,385848,3494817,109777,6196261
2020/6/26,1259685,1839450,576127,4834117,109629,8619008
2020/6/27,929285,1260676,574996,3599550,110205,6474712
2020/6/28,706902,940885,429348,12710000,110575,14897710
2020/6/29,419713,442824,190221,4789464,109739,5951961
2020/6/30,406132,669014,247056,3410562,109699,4842463
2020/7/1,433279,18049471,221094,19609525,113153,38426522
2020/7/2,465769,809715,224107,1772182,112997,3384770
2020/7/3,496977,1846924,262034,7987332,112530,10705797
2020/7/4,679678,2189744,383158,3555646,109811,6918037
2020/7/5,908370,1808102,471064,3554118,107429,6849083
2020/7/6,849591,1684986,345238,3226260,106810,6212885
2020/7/7,594764,1388032,324181,2571529,113776,4992282
2020/7/8,575695,920558,300582,2037132,110214,3944181
2020/7/9,643997,1593570,465977,5221888,110101,8035533
2020/7/10,1147064,3079599,499813,6634698,95701,11456875
2020/7/11,884504,13668893,404791,17584525,106594,32649307
2020/7/12,985950,0,345473,102484868,93112,103909403
2020/7/13,869359,6080014,266860,7780260,94122,15090615
2020/7/14,665575,2510738,184253,15762159,106802,19229527
2020/7/15,852636,9410904,298377,10879528,110196,21551641
2020/7/16,742637,6616161,378378,9503907,108733,17349816
2020/7/17,749987,1804123,286382,2856214,106801,5803507
2020/7/18,801404,1582500,274358,5418129,106626,8183017
2020/7/19,880076,1634215,266858,3340980,90703,6212832
2020/7/20,852558,1410042,196689,112892086,92299,115443674
2020/7/21,724578,834439,180684,2050962,106768,3897431
2020/7/22,709403,837157,154960,5460922,110042,7272484
2020/7/23,724399,1209637,128046,4783585,108601,6954268
2020/7/24,698457,1063410,106766,3761006,62052,5691691
2020/7/25,713659,1041737,97768,3711283,60669,5625116
2020/7/26,803032,1152333,118682,3903492,78761,6056300
2020/7/27,785712,1064240,104620,3758836,76379,5789787
2020/7/28,691882,844662,83285,3362591,108212,5090632
2020/7/29,685332,503887,94441,3021903,108495,4414058
2020/7/30,678231,1455259,92564,3924369,108783,6259206
2020/7/31,682733,927479,108031,3438390,108102,5264735
2020/8/1,723706,976292,124806,3468684,102175,5395663
2020/8/2,781566,1081926,127043,3653308,106704,5750547
2020/8/3,769119,994305,101670,3513358,109556,5488008
2020/8/4,691632,906707,124362,3325970,108917,5157588
2020/8/5,717217,793153,156286,1886641,108381,3661678
2020/8/6,707841,1555644,133752,5435829,98700,7931766
2020/8/7,693684,920552,138582,1967373,106848,3827039
2020/8/8,705490,1188207,140384,3662304,107506,5803891
2020/8/9,747056,1245223,134631,5225990,107165,7460065
2020/8/10,747612,1221765,123473,2315210,107542,4515602
2020/8/11,690405,1117165,108498,4641759,102691,6660518
2020/8/12,693868,1211018,118821,2230576,84031,4338314
2020/8/13,697465,1084166,100898,2091027,106630,4080186
2020/8/14,695493,1085000,116963,5751536,91891,7740883
2020/8/15,697193,1328500,104155,2338832,90724,4559404
2020/8/16,731208,1287775,114683,2359255,54090,4547011
2020/8/17,746295,1402785,100652,5651470,45300,7946502
2020/8/18,718582,1312169,140529,2396862,38137,4606279
2020/8/19,730228,1398192,105379,2458420,110110,4802329
2020/8/20,710167,2302851,223029,11764909,108667,15109623
2020/8/21,727488,8604068,593786,12019290,88387,22033019
2020/8/22,719703,14770236,585694,120799476,108558,136983667
2020/8/23,730566,10611149,613799,14174306,110540,26240360
2020/8/24,723563,8329735,634019,11237981,109856,21035154
2020/8/25,696657,7344007,478645,10288427,109854,18917590
2020/8/26,722009,6781487,515646,9755839,109779,17884760
2020/8/27,700707,6373149,576757,9379986,110043,17140642
2020/8/28,716937,5083268,513638,8856000,109387,15279230
2020/8/29,738120,5816310,571600,7595733,109705,14831468
2020/8/30,757707,5616091,541131,8949193,110104,15974226
2020/8/31,711773,5306281,518688,8203059,108131,14847932
2020/9/1,556164,4524695,257952,6615802,108919,12063532
2020/9/2,678840,3872484,462276,8074441,108258,13196299
2020/9/3,0,3483179,79402,10877726,108907,14549214
2020/9/4,301921,3582519,264284,5587404,108861,9844989
2020/9/5,509235,4080051,240797,6336928,106722,11273733
2020/9/6,810089,4311299,293650,6845927,86698,12347663
2020/9/7,632103,3929666,197026,6695141,108055,11561991
2020/9/8,270437,3058778,185280,4817939,109822,8442256
2020/9/9,269782,2930844,161045,4932374,110160,8404205
2020/9/10,269089,3032059,159257,5124404,106625,8691434
2020/9/11,308023,3288643,149878,5094770,107464,8948778
2020/9/12,568651,3721233,211324,5802542,83887,10387637
2020/9/13,902316,3910389,223175,6817275,106894,11960049
2020/9/14,662654,3498294,145786,5293223,106852,9706809
2020/9/15,261070,2941992,140420,4986114,106958,8436554
2020/9/16,256035,2832186,139661,4434061,108822,7770765
2020/9/17,272895,2887900,119028,4273392,91045,7644260
2020/9/18,277744,3109326,151321,4541268,107125,8186784
2020/9/19,545320,3447188,153828,5158363,83735,9388434
2020/9/20,903131,3150414,169575,5286665,106909,9616694
2020/9/21,669897,2581089,204499,4515241,107073,8077799
2020/9/22,263352,2193178,40422,4941475,108868,7547295
2020/9/23,248494,2094253,25411,3489919,113065,5971142
2020/9/24,248366,2385617,233353,4020719,112682,7000737
2020/9/25,604494,5107194,262292,109919844,113112,116006936
2020/9/26,733864,14896825,157274,19162282,112954,35063199
2020/9/27,831411,3268567,101261,5980503,112647,10294389
2020/9/28,307193,1992803,87859,4358816,109982,6856653
2020/9/29,279391,1732527,90544,2499041,108640,4710143
2020/9/30,55021,2274907,153434,2858841,109812,5452015
2020/10/1,971311,3654845,170114,7883612,113319,12793201
2020/10/2,1534768,2827699,144418,6514345,113526,11134756
2020/10/3,1134617,1987771,146123,4446533,108256,7823300
2020/10/4,945481,1733667,119707,3295815,108622,6203292
2020/10/5,839516,1441551,55642,4775660,108278,7220647
2020/10/6,751156,1300611,183508,3771788,108998,6116061
2020/10/7,688876,1247339,104372,3741931,110492,5893010
2020/10/8,632874,1043188,108192,1989819,110003,3884076
2020/10/9,512083,728154,70788,4710270,108406,6129701
2020/10/10,254662,836171,73714,2491018,109003,3764568
2020/10/11,385167,966352,92605,2362836,109085,3916045
2020/10/12,537871,668757,60213,2330631,108914,3706386
2020/10/13,220203,630858,56340,1911286,109934,2928621
2020/10/14,223499,595009,65770,1838229,113587,2836094
2020/10/15,229867,605387,55415,1669555,112480,2672704
2020/10/16,268535,864168,69358,1393958,113666,2709685
2020/10/17,554253,1193580,94063,2031495,113686,3987077
2020/10/18,854408,1043573,84410,2331422,112968,4426781
2020/10/19,616988,645436,49323,1507297,113001,2932045
2020/10/20,238747,515131,43166,964586,112032,1873662
2020/10/21,229352,504171,36134,930308,112671,1812636
2020/10/22,232959,553331,35113,982610,112934,1916947
2020/10/23,474280,753902,46327,1440242,113241,2827992
2020/10/24,512891,1054810,91225,8212287,112846,9984059
2020/10/25,804483,954612,82665,2069853,112450,4024063
2020/10/26,613424,591276,50802,1686333,112735,3054570
2020/10/27,251943,479152,31907,927314,113346,1803662
2020/10/28,255429,557909,46317,10072242,113083,11044980
2020/10/29,292982,522668,40594,928098,109996,1894338
2020/10/30,291831,870914,58510,1412326,112703,2746284
2020/10/31,599638,1123309,85474,1926841,112654,3847916
2020/11/1,904743,1090839,95926,12098071,110650,14300229
2020/11/2,738307,624548,44827,4531716,110210,6049608
2020/11/3,274003,454209,41098,1615070,112664,2497044
2020/11/4,256348,550544,31588,5553715,108308,6500503
2020/11/5,249214,480411,29756,932144,108303,1799828
2020/11/6,263711,786135,38160,1264682,109999,2462687
2020/11/7,519354,1049068,67929,1731851,108437,3476639
2020/11/8,824262,983924,62975,2109442,110452,4091055
2020/11/9,601931,511567,32056,1737730,109736,2993020
2020/11/10,232288,411135,40167,841580,109608,1634778
2020/11/11,228320,454285,34463,10435604,109713,11262385
2020/11/12,11691,436116,32728,1073158,109590,1663283
2020/11/13,33898,738316,46766,998765,109695,1927440
2020/11/14,283338,1013410,64570,1646303,110521,3118142
2020/11/15,318862,919838,72892,1570118,107227,2988937
2020/11/16,640753,439661,37902,1221995,107527,2447838
2020/11/17,255351,421311,30627,761500,108488,1577277
2020/11/18,248964,398565,40810,743125,107392,1538856
2020/11/19,25162,459433,21813,564893,106803,1178104
2020/11/20,17268,658592,24909,761336,108982,1571087
2020/11/21,250751,981507,68288,1394838,100526,2795910
2020/11/22,304116,746280,73471,1128290,100647,2352804
2020/11/23,600453,476768,0,1177528,107394,2362143
2020/11/24,242616,362254,120295,2166605,106635,2998405
2020/11/25,234212,371313,35079,690898,106885,1438387
2020/11/26,232766,348616,31413,665918,91867,1370580
2020/11/27,255230,633747,0,100891075,100212,101880264
2020/11/28,266200,894059,0,1162482,91960,2414701
2020/11/29,292607,129045,0,699821,83351,1204824
2020/11/30,570248,421812,0,995445,98822,2086327
2020/12/1,236885,380413,0,10622152,108852,11348302
2020/12/2,13514,343747,0,416064,108099,881424
2020/12/3,243301,1372647,0,1671474,108384,3395806
2020/12/4,244758,654019,0,957524,110124,1966425
2020/12/5,261236,951671,0,1215296,110240,2538443
2020/12/6,331193,795992,0,1356266,100843,2584294
2020/12/7,597768,373328,0,1072029,75040,2118165
2020/12/8,242077,362218,0,10463521,52950,11120766
2020/12/9,19552,366478,672397,1060425,75807,2194659
2020/12/10,263071,387352,0,708722,90696,1449841
2020/12/11,6321,622489,138239,3329256,91063,4187368
2020/12/12,280283,819136,96873,1447973,90884,2735149
2020/12/13,311034,919913,91987,1701121,46093,3070148
2020/12/14,618670,3108764,47182,4364844,47664,8187124
2020/12/15,250016,510880,34306,959178,77327,1831707
2020/12/16,234312,346613,33441,781667,90749,1486782
2020/12/17,234323,310588,32880,785255,92110,1455156
2020/12/18,13102,594568,48085,4283260,99866,5038881
2020/12/19,251138,874260,79442,1388810,108763,2702413
2020/12/20,299910,763793,74864,1393951,108548,2641066
2020/12/21,574763,374080,40811,1396006,109636,2495296
2020/12/22,235751,296532,36461,727545,108495,1404784
2020/12/23,227519,321613,30466,734460,110391,1424449
2020/12/24,230760,329976,28456,748663,108424,1446279
2020/12/25,10582,529632,40361,691885,137431,1409891
2020/12/26,239728,859909,69005,1341555,136558,2646755
2020/12/27,290295,696848,62488,1296595,137801,2484027
2020/12/28,585484,367762,27352,1205409,129744,2315751
2020/12/29,260225,354868,26839,768567,94907,1505406
2020/12/30,34990,406345,29863,611466,129674,1212338
2020/12/31,34233,796981,57769,1028366,94493,2011842
2021/1/1,427931,1204925,87649,1994722,92762,3807989
2021/1/2,299632,914355,69730,1645251,101284,3030252
2021/1/3,785050,660406,50879,1765128,106847,3368310
2021/1/4,544359,301557,0,1045263,92753,1983932
2021/1/5,270651,390344,79804,870103,107297,1718199
2021/1/6,1588,199174,3965,10335005,107264,10646996
2021/1/7,35633,554923,66858,804793,92831,1555038
2021/1/8,40944,317895,50050,561632,107463,1077984
2021/1/9,232659,1175309,79067,1697052,58501,3242588
2021/1/10,229448,780614,0,1279392,51022,2340476
2021/1/11,619420,395781,0,1234514,91233,2340948
2021/1/12,366765,346077,188062,1050654,99990,2051548
2021/1/13,354059,396855,43766,942567,108714,1845961
2021/1/14,38810,1595588,333834,3432513,108081,5508826
2021/1/15,1337934,3740109,406909,8866967,108824,14460743
2021/1/16,1420015,15244130,379480,20107042,108254,37258921
2021/1/17,1380927,3596907,298959,6710435,115091,12102319
2021/1/18,912403,1347772,198969,3166083,109925,5735152
2021/1/19,557066,1373950,174312,2111719,119313,4336360
2021/1/20,561762,919663,158224,2342356,109632,4091637
2021/1/21,61422,1228611,148133,1758846,109911,3306923
2021/1/22,53711,725629,154827,1257084,110223,2301474
2021/1/23,174484,1287809,154802,1993798,108188,3719081
2021/1/24,108920,1693758,154445,2353273,108327,4418723
2021/1/25,836895,1036184,124548,2350572,44430,4392629
2021/1/26,731084,846242,109449,1985839,79224,3751838
2021/1/27,86020,1286298,88176,1779986,107150,3347630
2021/1/28,8875,923603,85505,1335199,109821,2463003
2021/1/29,48263,1265278,89983,1739501,110082,3253107
2021/1/30,27957,1181566,92594,1653700,110170,3065987
2021/1/31,898128,778517,97666,2128792,108215,4011318
2021/2/1,873268,1169075,96696,2479632,90647,4709318
2021/2/2,851197,3469408,88384,4730548,90976,9230513
2021/2/3,7809,1092128,79378,1497856,91705,2768876
2021/2/4,857311,831632,77136,2076587,107327,3949993
2021/2/5,863571,1010334,67985,2265342,61959,4269191
2021/2/6,25602,1119934,76309,1544463,46428,2812736
2021/2/7,19540,1067006,80200,1513316,74743,2754805
2021/2/8,10100,1238493,84766,11678315,63949,13075623
2021/2/9,22157,1041620,79422,1508701,44381,2696281
2021/2/10,28104,1557719,80771,2035752,95317,3797663
2021/2/11,71504,1161406,91457,1730787,75056,3130210
2021/2/12,232384,1049707,88609,1834824,81084,3286608
2021/2/13,1105364,1659481,81482,3216619,77538,6140484
2021/2/14,1113322,826734,82349,2363967,91500,4477872
2021/2/15,1020984,1414150,81621,2833834,75064,5425653
2021/2/16,965863,2050881,80110,113402388,76134,116575376
2021/2/17,901490,667229,74173,1937502,106832,3687226
2021/2/18,832263,974459,78240,2158203,92438,4135603
2021/2/19,785223,1583423,71885,2694585,132385,5267501
2021/2/20,763971,964227,74242,2050739,109562,3962741
2021/2/21,711109,804939,73597,1831600,110279,3531524
2021/2/22,687530,1801703,71364,2799809,110218,5470624
2021/2/23,631892,524903,68241,1440046,110300,2775382
2021/2/24,630456,775293,65167,1681974,124202,3277092
2021/2/25,612083,859669,64635,11746626,113654,13396667
2021/2/26,38474,605913,66553,938826,112576,1762342
2021/2/27,66702,1025670,67098,1415940,112616,2688026
2021/2/28,678232,535526,65033,1522645,113060,2914496
2021/3/1,530500,401598,41536,1177489,113924,2265047
2021/3/2,303455,409559,31842,879118,113544,1737518
2021/3/3,278581,184269,33582,625635,112767,1234834
2021/3/4,260261,308152,27353,719576,113200,1428542
2021/3/5,8326,689912,43673,887349,112821,1742081
2021/3/6,281426,466411,75357,1054173,112580,1989947
2021/3/7,283912,1059867,63984,1710710,110182,3228655
2021/3/8,596376,1045980,39682,11909508,139039,13730585
2021/3/9,273675,0,31101,439781,109596,854153
2021/3/10,251214,414754,28953,822621,112592,1630134
2021/3/11,4396,328466,31067,494002,112617,970548
2021/3/12,21345,636206,45258,837457,109816,1650082
2021/3/13,298638,1276002,81926,1873290,108821,3638677
2021/3/14,288593,546633,64886,1195358,107393,2202863
2021/3/15,612039,465650,35868,1336684,91703,2541944
2021/3/16,252242,339992,33034,625268,70627,1321163
2021/3/17,252009,267119,33008,810394,106740,1469270
2021/3/18,255100,446576,24951,855024,139910,1721561
2021/3/19,9461,252365,36656,2503326,108990,2910798
2021/3/20,265046,1058329,64165,1594013,108986,3090539
2021/3/21,306032,674307,57145,1324017,107007,2468508
2021/3/22,595075,504256,31312,3425102,108696,4664441
2021/3/23,239223,361905,28660,748395,99997,1478180
2021/3/24,247914,164918,28748,558045,107518,1107143
2021/3/25,247096,293602,25192,683001,110075,1358966
2021/3/26,13324,297043,28291,459194,113139,910991
2021/3/27,267944,892420,78730,1441108,124418,2804620
2021/3/28,302386,1047034,57150,1409257,108118,2923945
2021/3/29,610860,344105,30457,1483051,108408,2576881
2021/3/30,240950,218739,27056,487869,108208,1082822
2021/3/31,242693,325171,21738,836626,108356,1534584
2021/4/1,19017,285639,23724,460915,104239,893534
2021/4/2,30142,692722,44332,768415,96142,1631753
2021/4/3,372690,980275,78840,1433419,87314,2952538
2021/4/4,407579,931971,66298,1409364,107323,2922535
2021/4/5,916414,799131,53016,1771897,107110,3647568
2021/4/6,597350,338960,27905,2287631,98557,3350403
2021/4/7,243626,191222,23622,630665,108287,1197422
2021/4/8,238362,616887,216481,11319625,108154,12499509
2021/4/9,418071,1534039,292816,5906355,108248,8259529
2021/4/10,81561,10036091,249072,10371690,106616,20845030
2021/4/11,207616,4043061,193710,9084291,107010,13635688
2021/4/12,650919,1437396,125105,5254068,106712,7574200
2021/4/13,262935,583980,89766,1394118,124445,2455244
2021/4/14,268889,604256,87232,1282225,150207,2392809
2021/4/15,36305,671707,62069,1045764,110370,1926215
2021/4/16,307017,381522,97464,3144620,108004,4038627
2021/4/17,259521,1378673,135870,1774064,106949,3655077
2021/4/18,264958,948332,119495,1663662,107258,3103705
2021/4/19,588663,558097,75277,1222037,107005,2551079
2021/4/20,236922,354778,55159,1541838,39006,2227703
2021/4/21,240658,255876,42660,705397,108117,1352708
2021/4/22,236946,286493,37307,718011,107342,1386099
2021/4/23,8568,616687,42545,822894,108869,1599563
2021/4/24,209874,742574,60689,3636067,106762,4755966
2021/4/25,185871,421060,41736,1235723,108634,1993024
2021/4/26,273187,273151,25742,793300,115752,1481132
2021/4/27,235652,342426,27210,800554,108986,1514828
2021/4/28,7437,342203,29920,577303,110043,1066906
2021/4/29,29228,320646,29844,2711192,108016,3198926
2021/4/30,30566,475765,61214,728470,106874,1402889
2021/5/1,493438,1458946,102142,2539856,107480,4701862
2021/5/2,401104,1004259,86476,1681561,76346,3249746
2021/5/3,951486,1182058,82244,2801197,75093,5092078
2021/5/4,837727,1159049,76047,2195612,58339,4326774
2021/5/5,723330,809628,69630,1709338,46623,3358549
2021/5/6,572050,329266,42083,1920638,79314,2943351
2021/5/7,248302,344261,36282,1087177,107474,1823496
2021/5/8,243091,144791,36175,2720834,90560,3235451
2021/5/9,177240,909486,53395,1211247,75373,2426741
2021/5/10,161407,359558,30549,1047315,90637,1689466
2021/5/11,1045636,276200,26399,1521661,79096,2948992
2021/5/12,238903,306153,23457,745976,126622,1441111
2021/5/13,976738,188626,23829,1361085,106610,2656888
2021/5/14,1208687,382525,37121,1629465,100335,3358133
2021/5/15,2358282,1252852,67612,3755810,81462,7516018
2021/5/16,2423240,697028,58290,3741448,66560,6986566
2021/5/17,3296862,191300,32402,3814857,64075,7399496
2021/5/18,3067209,237685,31521,3453784,68030,6858229
2021/5/19,250650,445544,16909,883956,107403,1704462
2021/5/20,752344,332939,26449,1161373,106812,2379917
2021/5/21,256225,170849,26578,747187,108065,1308904
2021/5/22,944310,1120181,47744,2364582,108765,4585582
2021/5/23,778595,663474,39894,1837849,108814,3428626
2021/5/24,4314915,413123,18826,5111019,107456,9965339
2021/5/25,1293243,226412,16587,1649473,150022,3335737
2021/5/26,4488792,316038,16853,4979852,109503,9911038
2021/5/27,2216177,445637,18909,2945391,110149,5736263
2021/5/28,2131286,264272,28970,2589884,110533,5124945
2021/5/29,2501430,1077220,48469,3883611,108492,7619222
2021/5/30,1989719,580512,40365,2970200,101752,5682548
2021/5/31,4707842,625247,21546,5636112,108867,11099614
2021/6/1,360991,287627,24572,843140,119934,1636264
2021/6/2,928117,421618,20371,3686079,110183,5166368
2021/6/3,1850961,303915,19063,2377022,109787,4660748
2021/6/4,823547,216231,29617,1273157,109702,2452254
2021/6/5,3040658,1167220,51719,4539039,109906,8908542
2021/6/6,2089424,510958,43414,3028267,109779,5781842
2021/6/7,4468337,588729,23211,7509111,110294,12699682
2021/6/8,2920203,227752,24442,3374679,109887,6656963
2021/6/9,1369980,439159,27357,2075251,101104,4012851
2021/6/10,1731474,492830,26527,2516675,109780,4877286
2021/6/11,2511123,326082,31156,3130361,107233,6105955
2021/6/12,1831088,1279388,51795,3483227,91321,6736819
2021/6/13,1820575,669613,50571,2969689,60482,5570930
2021/6/14,5749695,1077754,43844,7284023,91169,14246485
2021/6/15,4871334,291606,23968,105548166,98736,110833810
2021/6/16,7122300,348284,42881,7570750,107267,15191482
2021/6/17,2581324,555165,32750,3373184,107355,6649778
2021/6/18,362395,521326,37897,3417075,107466,4446159
2021/6/19,1946819,853101,56213,3141135,88023,6085291
2021/6/20,3192141,707488,57558,4329492,77676,8364355
2021/6/21,3239291,417687,38193,4019061,76243,7790475
2021/6/22,4426500,405252,32330,5095465,76274,10035821
2021/6/23,3268268,987038,203703,4526903,106961,9092873
2021/6/24,3900676,1370129,221991,8959426,107228,14559450
2021/6/25,4329314,8882512,128753,18571696,106795,32019070
2021/6/26,4452116,5007764,116625,12738683,100298,22415486
2021/6/27,5415022,2432601,105767,8587809,91618,16632817
2021/6/28,3394123,1262894,76842,5224654,95877,10054390
2021/6/29,2584872,956863,72972,4120781,93682,7829170
2021/6/30,557954,969551,64542,4153686,97537,5843270
2021/7/1,1264652,948687,62467,2727209,92451,5095466
2021/7/2,2487676,960899,77359,3952144,106631,7584709
2021/7/3,2978048,1067748,17228,4401196,108923,8573143
2021/7/4,5029048,1087231,8196,6265225,108220,12497920
2021/7/5,5084094,691070,112609,6784518,107137,12779428
2021/7/6,3324840,793868,156563,4372361,107247,8754879
2021/7/7,2060864,840941,47716,5851500,108192,8909213
2021/7/8,1347218,816597,45817,2310849,98732,4619213
2021/7/9,2060607,853062,35695,3538664,108526,6596554
2021/7/10,4095275,849591,51558,5360047,86712,10443183
2021/7/11,2186967,726692,82038,3106313,89349,6191359
2021/7/12,3584641,939095,56594,4962371,99168,9641869
2021/7/13,7162743,398117,52644,8256344,106606,15976454
2021/7/14,3261043,1123195,51351,6899065,98981,11433635
2021/7/15,3227119,741360,37519,4343945,106682,8456625
2021/7/16,2577553,724075,47711,3663874,108804,7122017
2021/7/17,677663,791521,63884,1868505,108667,3510240
2021/7/18,1394464,757732,59961,2488901,90694,4791752
2021/7/19,4097763,695542,57343,5265484,113041,10229173
2021/7/20,5567193,711889,46843,6723042,107325,13156292
2021/7/21,4604364,691802,34847,5660882,119663,11111558
2021/7/22,4634161,668368,52932,5556844,113207,11025512
2021/7/23,1923008,706484,44576,5156297,108397,7938762
2021/7/24,2575188,746402,47449,3660166,108551,7137756
2021/7/25,2036958,769374,41718,5275707,91185,8214942
2021/7/26,691238,670829,52718,1647375,74668,3136828
2021/7/27,2667624,767275,47590,3801527,52419,7336435
2021/7/28,1391502,767690,48922,2445066,55232,4708412
2021/7/29,736699,752305,41153,1846653,60123,3436933
2021/7/30,2835930,759329,32068,3936781,107448,7671556
2021/7/31,3548121,753279,48571,6782975,83849,11216795
2021/8/1,4259777,810286,47036,5467668,75908,10660675
2021/8/2,4985776,784976,44760,6181565,90829,12087906
2021/8/3,3529167,760679,39307,4570174,61936,8961263
2021/8/4,3581723,763672,33636,4714356,60307,9153694
2021/8/5,2144805,701249,34641,3196463,88623,6165781
2021/8/6,2861648,793678,35192,4009130,104723,7804371
2021/8/7,4312134,382147,35125,5068493,105445,9903344
2021/8/8,3631413,1326925,49109,5354725,109933,10472105
2021/8/9,4424044,559325,41202,5369901,109795,10504267
2021/8/10,2209591,991815,34273,3565609,106866,6908154
2021/8/11,3667275,597616,39205,4615063,109791,9028950
2021/8/12,6575625,961153,38408,7906301,106588,15588075
2021/8/13,3638015,731114,36378,4729121,84260,9218888
2021/8/14,4381590,586818,46101,5351066,107274,10472849
2021/8/15,5157605,1068112,45268,6645658,49851,12966494
2021/8/16,5891911,721522,43284,7005292,45972,13707981
2021/8/17,6619735,667031,30890,7662096,106906,15086658
2021/8/18,4362123,790222,32010,5522803,108570,10815728
2021/8/19,3510375,865712,42639,4738073,100238,9257037
2021/8/20,2098652,696879,33298,3148877,95830,6073536
2021/8/21,3475848,825988,26329,4648121,98963,9075249
2021/8/22,2099043,733670,37530,3211172,108528,6189943
2021/8/23,5628564,747888,51572,6760187,96804,13285015
2021/8/24,674772,799873,34365,1824167,107010,3440187
2021/8/25,1460858,5482190,103753,9345522,120172,16512495
2021/8/26,2851185,14267428,456121,121446733,108557,139130024
2021/8/27,3509963,5976654,431303,12214657,108180,22240757
2021/8/28,2761724,3955750,421098,9238681,86384,16463637
2021/8/29,3485194,2877332,436935,9013402,108156,15921019
2021/8/30,4833658,2159159,353051,9856986,108956,17311810
2021/8/31,3905577,1679897,137134,7815437,108399,13646444
2021/9/1,2833302,1624826,383632,7339467,108331,12289558
2021/9/2,2091056,1211572,329832,4227776,108425,7968661
2021/9/3,2896732,1116751,245087,4763473,108913,9130956
2021/9/4,3372141,1293067,326712,5527913,90684,10610517
2021/9/5,2416627,1201020,249346,4514954,78653,8460600
2021/9/6,2994994,787417,201617,6705735,76354,10766117
2021/9/7,3027379,610720,206719,4438307,44778,8327903
2021/9/8,2601976,640395,119426,3888136,50354,7300287
2021/9/9,1657612,619898,67920,2711772,106837,5164039
2021/9/10,827972,834559,111858,2135415,89566,3999370
2021/9/11,1618738,1123024,114478,3355930,63226,6275396
2021/9/12,2664446,1024689,167128,4433006,53415,8342684
2021/9/13,3113079,620711,96252,4465729,62140,8357911
2021/9/14,1596810,481074,77574,2953711,69120,5178289
2021/9/15,1427943,474660,50797,2464593,90769,4508762
2021/9/16,1718212,468677,47662,2555876,161864,4952291
2021/9/17,1647279,482709,43738,2465521,217180,4856427
2021/9/18,1203289,802524,56924,2387064,107255,4557056
2021/9/19,2104170,1215570,83995,3829760,86431,7319926
2021/9/20,2804766,1190521,100472,4668365,107270,8871394
2021/9/21,4251279,1036022,164875,8302899,110023,13865098
2021/9/22,6580649,529291,82509,8089441,109743,15391633
2021/9/23,4283316,513619,138607,7552916,107041,12595499
2021/9/24,4988270,1079866,245073,10434427,108178,16855814
2021/9/25,2177207,10195538,138180,14257922,107192,26876039
2021/9/26,2520462,2881179,140352,6544227,106706,12192926
2021/9/27,243844,1675572,43882,2921812,106850,4991960
2021/9/28,1689896,1328894,53561,3694248,108678,6875277
2021/9/29,5619,907435,44514,1200996,107431,2265995
2021/9/30,933609,1194210,48623,2429718,108352,4714512
2021/10/1,1750010,1882969,88777,4292663,107104,8121523
2021/10/2,3470688,1762522,82436,5947038,95683,11358367
2021/10/3,6190079,1191057,76889,7929426,75939,15463390
2021/10/4,5198705,935971,83163,6671638,82379,12971856
2021/10/5,5507769,801318,92969,6493791,80822,12976669
2021/10/6,5599697,749353,67027,9038824,89955,15544856
2021/10/7,4480385,582687,86113,5548550,76873,10774608
2021/10/8,4312798,424119,38815,7367935,74907,12218574
2021/10/9,3232387,460694,36040,4214444,74807,8018372
2021/10/10,1457442,575204,50142,2334173,91630,4508591
2021/10/11,2171692,271703,33911,2765738,90516,5333560
2021/10/12,2613651,294540,33767,5245266,108527,8295751
2021/10/13,1557906,281199,28770,2044132,110179,4022186
2021/10/14,2062769,260269,27514,2498640,109406,4958598
2021/10/15,585640,266292,34589,1019057,108223,2013801
2021/10/16,1234083,733783,45054,2241464,108928,4363312
2021/10/17,2795404,835226,67364,4025278,108254,7831526
2021/10/18,2668700,224713,29652,3160107,106706,6189878
2021/10/19,3466762,189520,27105,3823334,108986,7615707
2021/10/20,1415093,279780,19396,1844857,108730,3667856
2021/10/21,529509,239610,16664,914174,108248,1808205
2021/10/22,367326,223366,27546,753717,108592,1480547
2021/10/23,1367140,691204,19924,2301644,108882,4488794
2021/10/24,2536985,660917,46243,3527887,106785,6878817
2021/10/25,1636216,244695,28943,2118632,110169,4138655
2021/10/26,4207990,309243,16611,4656784,110245,9300873
2021/10/27,1851995,207088,19284,2200403,109924,4388694
2021/10/28,855656,240704,17790,1232395,109845,2456390
2021/10/29,231362,150388,19753,532217,110597,1044317
2021/10/30,993975,848130,33700,2099127,109779,4084711
2021/10/31,1097294,500694,34959,1965904,110130,3708981
2021/11/1,4129572,382606,21299,4757057,108831,9399365
2021/11/2,3164491,292783,19020,103624870,108114,107209278
2021/11/3,1970688,304505,12806,2443898,106833,4838730
2021/11/4,2676279,251881,16102,3090541,108722,6143525
2021/11/5,822567,410851,20125,1398704,108626,2760873
2021/11/6,1644514,695368,20510,2577644,108606,5046642
2021/11/7,2106270,533659,41273,2970813,108664,5760679
2021/11/8,2546004,197846,21082,2939656,110570,5815158
2021/11/9,3855886,286033,17491,4263863,110235,8533508
2021/11/10,1285995,170836,16505,1617415,110126,3200877
2021/11/11,608147,286439,18313,1009970,110139,2033008
2021/11/12,222271,246556,18139,627997,109805,1224768
2021/11/13,1046316,578782,34603,1879143,110098,3648942
2021/11/14,2090648,573520,46451,2929911,109754,5750284
2021/11/15,2991750,297889,22840,3537290,110300,6960069
2021/11/16,3187647,204114,16760,3519586,109631,7037738
2021/11/17,206834,188581,15838,516254,109650,1037157
2021/11/18,822306,320687,10548,1282692,110182,2546415
2021/11/19,1259055,401036,16222,1811914,110161,3598388
2021/11/20,1850496,652406,25175,2732718,110058,5370853
2021/11/21,2281971,495280,27686,3082364,109649,5996950
2021/11/22,3272763,219029,17771,3717866,110388,7337817
2021/11/23,1911089,192208,11613,2245927,110114,4470951
2021/11/24,943268,180531,11257,1251906,110292,2497254
2021/11/25,1099062,215819,12183,3555036,109386,4991486
2021/11/26,958912,705360,15471,1805071,109701,3594515
2021/11/27,1390824,331340,27622,1799295,109883,3658964
2021/11/28,2813986,466354,30906,3586311,109373,7006930
2021/11/29,3541366,222890,19838,4142683,110126,8036903
2021/11/30,2497062,205317,14733,2844022,110294,5671428
2021/12/1,2276124,157117,11794,2580405,109942,5135382
2021/12/2,1417895,221265,16908,1780221,110473,3546762
2021/12/3,2021461,251488,17865,2420019,109646,4820479
2021/12/4,1614999,835103,26666,2694723,110254,5281745
2021/12/5,2966387,392358,29756,3668601,110094,7167196
2021/12/6,3811146,549443,15375,4578480,109714,9064158
2021/12/7,2143929,0,15459,2284591,110347,4554326
2021/12/8,3838858,264170,11311,4236014,110289,8460642
2021/12/9,1384346,170908,12294,1691801,109767,3369116
2021/12/10,948584,405781,15156,1498567,109531,2977619
2021/12/11,195924,381626,32916,813134,110401,1534001
2021/12/12,1456316,497116,27072,2257544,110524,4348572
2021/12/13,3304427,331579,13648,3855315,110009,7614978
2021/12/14,1422952,249595,13032,1819503,109360,3614442
2021/12/15,563114,147072,13029,854017,110412,1687644
2021/12/16,740477,219824,9651,1108319,110306,2188577
2021/12/17,1117184,210142,18844,1486225,108095,2940490
2021/12/18,1120831,727427,22896,2085579,106884,4063617
2021/12/19,1694712,380826,26975,2390579,93070,4586162
2021/12/20,2672839,277334,17265,3176514,109827,6253779
2021/12/21,1524703,153042,12227,1828274,110181,3628427
2021/12/22,2420529,287601,13035,2857681,110105,5688951
2021/12/23,2260498,204286,12986,2612396,110126,5200292
2021/12/24,1098169,372689,10760,1621765,110720,3214103
2021/12/25,1293387,592611,25827,1958477,109851,3980153
2021/12/26,2263404,637630,22249,3210371,110319,6243973
2021/12/27,1559725,53489,27966,2072256,109969,3823405
2021/12/28,206610,113350,13997,490485,110354,934796
2021/12/29,3122922,325813,12078,3606690,107526,7175029
2021/12/30,1005286,240980,11392,1411426,99674,2768758
2021/12/31,1497011,566420,17838,2244364,108813,4434446
2022/1/1,1494745,863561,36206,2723608,86369,5204489
2022/1/2,3690150,867638,21075,5006060,73288,9658211
2022/1/3,3909591,0,12664,3992970,91792,8007017
2022/1/4,5108336,112588,7417,5692959,106788,11028088
2022/1/5,2832348,50079,7427,3052293,107461,6049608
2022/1/6,1485331,557827,47166,2251038,99371,4440733
2022/1/7,2565123,2261532,62840,8911114,107457,13908066
2022/1/8,3552192,9543318,49755,13454414,106696,26706375
2022/1/9,4128551,3040609,21350,8155370,91554,15437434
2022/1/10,4764150,1435326,27528,8423150,75952,14726106
2022/1/11,3668933,1072848,42909,5324837,92845,10202372
2022/1/12,13644,861420,26539,1355045,108680,2365328
2022/1/13,1402715,815415,22499,2646373,109941,4996943
2022/1/14,1498320,843333,24600,2721550,108867,5196670
2022/1/15,2732847,1010271,44201,4202916,108974,8099209
2022/1/16,2614311,1027898,36949,4160552,109010,7948720
2022/1/17,1833298,643583,31854,2924935,108056,5541726
2022/1/18,3028397,757685,32088,4172764,108334,8099268
2022/1/19,4764446,714210,28287,5877933,110042,11494918
2022/1/20,2926849,767169,30001,4064557,110262,7898838
2022/1/21,3680341,895688,27960,4945556,108633,9658178
2022/1/22,2694255,847524,36894,3971745,108766,7659184
2022/1/23,2910195,818197,34945,4171940,108494,8043771
2022/1/24,4916627,744133,31908,106074404,108345,111875417
2022/1/25,3536607,803480,31681,4730253,90521,9192542
2022/1/26,1484665,852863,35059,2763974,109737,5246298
2022/1/27,1442485,1601854,29327,3465853,110425,6649944
2022/1/28,1444575,864555,37171,2646241,108788,5101330
2022/1/29,3727065,874681,27020,5050943,110701,9790410
2022/1/30,3879873,879301,42925,5222215,107012,10131326
2022/1/31,4581075,1069414,37859,8252607,98834,14039789
2022/2/1,5902534,1022087,38104,7413861,107251,14483837
2022/2/2,6195003,961471,18403,7545488,90841,14811206
2022/2/3,7274358,849128,43031,8514715,91247,16772479
2022/2/4,6842928,783131,27903,7968851,101567,15724380
2022/2/5,7294813,766727,25484,8390025,99393,16576442
2022/2/6,6160021,719149,21444,7186567,77258,14164439
2022/2/7,5341555,664599,30148,6310004,109854,12456160
2022/2/8,4618909,624361,24360,5515624,109641,10892895
2022/2/9,4333363,573569,21138,5215266,110438,10253774
2022/2/10,5591596,564372,20406,6457246,109605,12743225
2022/2/11,4038200,587773,24952,4931994,107244,9690163
2022/2/12,5708970,624781,25797,6594156,108941,13062645
2022/2/13,3418269,571169,21808,4255651,103881,8370778
2022/2/14,5125799,522853,26116,6075553,108266,11858587
2022/2/15,3879653,566626,22247,4725760,110110,9304396
2022/2/16,3635882,560387,17372,4467437,110528,8791606
2022/2/17,3879838,794527,12927,4856989,109666,9653947
2022/2/18,2275020,313066,10132,2758095,110315,5466628
2022/2/19,3369030,772930,26004,4365567,113770,8647301
2022/2/20,2788391,491094,18434,3542060,113172,6953151
2022/2/21,3429762,331001,13968,3977358,77252,7829341
2022/2/22,4612784,316293,65715,5135649,109748,10240189
2022/2/23,2900188,2054269,162658,10275802,112535,15505452
2022/2/24,1861665,13117417,88435,17903468,113356,33084341
2022/2/25,1783712,3104360,82005,7090464,113520,12174061
2022/2/26,2401497,2442687,90061,6658854,113815,11706914
2022/2/27,1404514,2597015,77600,5347133,106815,9533077
2022/2/28,1851886,1361595,55474,4905234,106935,8281124
2022/3/1,932305,806321,45158,4785215,108138,6677137
2022/3/2,1145646,593319,37089,2380493,113454,4270001
2022/3/3,1613834,499278,23308,2480183,74553,4691156
2022/3/4,1152912,685451,34691,2215924,113469,4202447
2022/3/5,1368548,1279114,70120,3186844,113073,6017699
2022/3/6,2717540,1282908,49112,4678501,113652,8841713
2022/3/7,3404132,778884,34286,4766680,109029,9093011
2022/3/8,3705230,632842,30151,4767665,75917,9211805
2022/3/9,2333482,502790,23278,5285683,91770,8237003
2022/3/10,1596147,459684,23405,2320234,92033,4491503
2022/3/11,266134,620116,28652,1177149,78449,2170500
2022/3/12,1362851,944974,44566,2728415,82920,5163726
2022/3/13,1614830,778619,42878,2908125,87276,5431728
2022/3/14,4655516,587725,36052,5652730,80625,11012648
2022/3/15,2789478,480468,23800,3558387,106959,6959092
2022/3/16,2565313,436638,23103,3274973,108280,6408307
2022/3/17,1777537,457054,25363,2527125,108386,4895465
2022/3/18,2951545,592275,20663,3865302,108665,7538450
2022/3/19,2248723,803685,37208,3464360,107307,6661283
2022/3/20,1688629,670186,29784,2823398,92313,5304310
2022/3/21,4280410,444119,20553,7225012,108245,12078339
2022/3/22,3644059,414316,15408,4338009,109650,8521442
2022/3/23,3567642,386640,12879,4215300,107403,8289864
2022/3/24,1335814,383698,20066,1916857,109021,3765456
2022/3/25,294504,524871,14006,1161458,108508,2103347
2022/3/26,1322040,796145,38401,2492066,108056,4756708
2022/3/27,1196446,614611,25058,2253699,108785,4198599
2022/3/28,3985754,612691,25475,4985040,108655,9717615
2022/3/29,3576064,182409,12567,4048576,108265,7927881
2022/3/30,1937434,355501,14140,2559466,108553,4975094
2022/3/31,1105296,393685,19188,1771821,108173,3398163
2022/4/1,1286264,462888,11706,2012935,108224,3882017
2022/4/2,792211,627773,25124,1714061,108733,3267902
2022/4/3,734882,810933,22162,1944087,107332,3619396
2022/4/4,3313244,790567,36397,4573291,108483,8821982
2022/4/5,2831039,641090,21512,3905244,107317,7506202
2022/4/6,4969313,462625,23353,5833827,99418,11388536
2022/4/7,2513348,414498,12347,3228390,91896,6260479
2022/4/8,311042,490141,20314,1046274,136060,2003831
2022/4/9,540436,689604,18046,1519010,110396,2877492
2022/4/10,1477274,586329,28671,2426280,122853,4641407
2022/4/11,3388890,398849,11731,4092868,40703,7933041
2022/4/12,1908319,394400,2448,2543892,49748,4898807
2022/4/13,1462739,352812,10169,2058010,74531,3958261
2022/4/14,899961,845828,66826,2035637,74574,3922826
2022/4/15,2029893,1869314,67734,8026152,102100,12095193
2022/4/16,3238633,7454131,73260,112562469,43561,123372054
2022/4/17,3588597,1716979,31149,6654867,80393,12071985
2022/4/18,3533617,1011685,31666,5521932,107349,10206249
2022/4/19,2813058,945558,15600,4409270,107063,8290549
2022/4/20,1776172,799819,20790,2947482,107284,5651547
2022/4/21,1264404,584087,12286,2103343,96556,4060676
2022/4/22,280082,629175,12072,1145855,98886,2166070
2022/4/23,1480255,723335,28812,2600305,98763,4931470
2022/4/24,1667136,660598,15319,2685738,96633,5125424
2022/4/25,2393753,527794,19247,3162448,107333,6210575
2022/4/26,2165720,498327,10269,2908566,91319,5674201
2022/4/27,1809916,381907,10798,2376082,90703,4669406
2022/4/28,2707007,393798,17044,3359483,90903,6568235
2022/4/29,1111466,465074,10762,1816638,90858,3494798
2022/4/30,1560195,1627488,37743,3526955,90554,6842935
2022/5/1,3512347,881551,19332,4795350,93073,9301653
2022/5/2,3074319,803975,16838,4450987,76438,8422557
2022/5/3,6641344,518141,23952,7499138,106878,14789453
2022/5/4,6636779,689949,12783,7622441,108746,15070698
2022/5/5,1881697,518746,14888,2622017,108686,5146034
2022/5/6,947966,476714,7672,1674836,108659,3215847
2022/5/7,591918,238399,9063,1069919,107534,2016833
2022/5/8,2346066,760287,20444,3323007,108156,6557960
2022/5/9,2105773,327316,7896,2695243,106603,5242831
2022/5/10,2345755,238739,12975,2844767,108531,5550767
2022/5/11,508526,370816,7298,1038539,60048,1985227
2022/5/12,1532004,184628,7655,1761376,106617,3592280
2022/5/13,775544,418918,15293,1540444,107022,2857221
2022/5/14,1581826,691152,13591,2554640,91950,4933159
2022/5/15,2814888,586364,14212,5676409,90597,9182470
2022/5/16,2790645,448639,14370,3488710,107433,6849797
2022/5/17,1612325,298391,6966,2073462,91945,4083089
2022/5/18,3502899,262011,11094,3921144,93481,7790629
2022/5/19,1685360,265564,5897,2103596,90929,4151346
2022/5/20,1711716,367777,6956,2215905,81606,4383960
2022/5/21,1054088,486618,19580,1769940,74822,3405048
2022/5/22,2401926,625586,12079,3314804,76804,6431199
2022/5/23,1918085,324202,12605,2540772,90761,4886425
2022/5/24,227000,306466,5892,734081,107218,1380657
2022/5/25,559939,167770,6428,734137,108450,1576724
2022/5/26,210082,288820,9546,778166,108148,1394762
2022/5/27,12459,399301,6093,566894,112651,1097398
2022/5/28,136729,410269,11576,622550,113810,1294934
2022/5/29,181545,694941,20346,907133,112664,1916629
2022/5/30,417926,261229,7013,1030870,113575,1830613
2022/5/31,210082,213250,10276,771737,109769,1315114
2022/6/1,540815,296489,6303,1112102,109794,2065503
2022/6/2,271133,282198,6448,734046,110294,1404119
2022/6/3,180555,735594,21370,1161583,109558,2208660
2022/6/4,296063,800394,11759,1473225,92192,2673633
2022/6/5,592695,494574,17749,1348700,107072,2560790
2022/6/6,482602,306199,6555,795356,108133,1698845
2022/6/7,298466,350870,6713,1021216,108819,1786084
2022/6/8,184136,351979,10878,895960,108648,1551601
2022/6/9,317775,244699,7349,814208,109935,1493966
2022/6/10,345028,444762,16129,1014612,109753,1930284
2022/6/11,106251,684968,11530,1039041,92153,1933943
2022/6/12,129408,414755,11467,923239,106947,1585816
2022/6/13,472886,314343,13366,1031058,107060,1938713
2022/6/14,283423,265077,6334,811844,108595,1475273
2022/6/15,270589,261980,11881,703269,108021,1355740
2022/6/16,14612,427569,6531,618465,81018,1148195
2022/6/17,34197,345207,7270,554017,80961,1021652
2022/6/18,135123,760246,19951,1268934,69995,2254249
2022/6/19,285201,425887,10808,726133,67644,1515673
2022/6/20,263954,409715,8582,1181667,69596,1933514
2022/6/21,372699,484651,11780,1059801,70656,1999587
2022/6/22,337569,293585,6599,863057,80323,1581133
2022/6/23,24580,684512,43848,925835,82156,1760931
2022/6/24,198009,2045334,58700,6518087,86136,8906266
2022/6/25,567787,2039099,40998,4739872,75093,7462849
2022/6/26,0,1390650,42881,1631350,75707,3140588
2022/6/27,676466,1006239,20300,2913359,74654,4691018
2022/6/28,569993,1094201,24304,3298717,75908,5063123
2022/6/29,425115,1017781,14713,1796700,82649,3336958
2022/6/30,456147,793213,13824,1514684,97031,2874899
2022/7/1,509711,1014457,22186,1902163,101893,3550410
2022/7/2,593877,892977,15693,1842497,82081,3427125
2022/7/3,665857,743409,24515,1498794,71805,3004380
2022/7/4,587500,726799,12231,1907807,72719,3307056
2022/7/5,481581,574763,11352,1412954,76868,2557518
2022/7/6,503387,607497,18977,1350972,83653,2564486
2022/7/7,521549,641338,11176,1396325,92217,2662605
2022/7/8,536982,668573,12138,1592673,90092,2900458
2022/7/9,578991,869042,21785,1731193,95297,3296308
2022/7/10,602998,416422,13484,1300881,126503,2460288
2022/7/11,586936,905493,20144,1826367,92224,3431164
2022/7/12,529200,598937,11053,1470247,69594,2679031
2022/7/13,528335,394317,11042,1197396,75062,2206152
2022/7/14,524613,662032,18298,1462433,80705,2748081
2022/7/15,534520,570401,11183,1376580,81042,2573726
2022/7/16,556276,544129,19584,1396461,68834,2585284
2022/7/17,573372,1030186,11746,1621102,61463,3297869
2022/7/18,560110,547222,11556,1406902,60642,2586432
2022/7/19,509304,685559,18223,1714536,64812,2992434
2022/7/20,507939,498627,10392,1269878,70960,2357796
2022/7/21,498088,632170,10136,1386720,76516,2603630
2022/7/22,504695,582594,17052,1353354,74816,2532511
2022/7/23,539213,606792,11420,1377173,68611,2603209
2022/7/24,550862,758106,19235,1378132,65576,2771911
2022/7/25,539981,607200,10225,1471921,55741,2685068
2022/7/26,489773,608117,9895,1356825,52719,2517329
2022/7/27,494323,596712,16219,1343767,58739,2509760
2022/7/28,496886,605702,9199,1360756,65952,2538495
2022/7/29,503531,615439,17175,1376000,70468,2582613
2022/7/30,533078,615406,10222,1442493,74134,2675333
2022/7/31,549885,596753,10830,1212336,60050,2429854
2022/8/1,546817,479835,17873,1549326,50673,2644524
2022/8/2,513729,518869,9733,1295524,48812,2386667
2022/8/3,503663,669789,9149,1418028,53434,2654063
2022/8/4,503760,571120,15973,1339670,57523,2488046
2022/8/5,504845,433322,9528,1198282,60642,2206619
2022/8/6,531931,683944,16956,1498017,50779,2781627
2022/8/7,548345,592689,10025,1427921,46570,2625550
2022/8/8,532371,525733,9781,1340359,45944,2454188
2022/8/9,505051,618571,16259,1388457,48544,2576882
2022/8/10,511955,693900,9635,1473337,55351,2744178
2022/8/11,516416,575040,16579,1359907,58315,2526257
2022/8/12,526458,592266,9348,1377995,61554,2567621
2022/8/13,544149,641871,10575,1465667,51815,2714077
2022/8/14,574257,612338,17876,1502266,49158,2755895
2022/8/15,542337,578548,9782,1422711,49502,2602880
2022/8/16,506172,560935,14755,1081862,52491,2216215
2022/8/17,491539,590046,8713,101332727,52517,102475542
2022/8/18,490703,504627,8503,1469535,58702,2532070
2022/8/19,483357,655580,14793,1355473,60403,2569606
2022/8/20,496404,574194,8813,1133420,52005,2264836
2022/8/21,514769,261753,8936,1267052,48086,2100596
2022/8/22,504034,744795,15221,1529949,46481,2840480
2022/8/23,479982,650039,8383,1336661,45665,2520730
2022/8/24,467963,627641,14041,1302451,49345,2461441
2022/8/25,448456,504844,7975,1271732,56309,2289316
2022/8/26,468411,569440,14478,1290877,55207,2398413
2022/8/27,486940,610580,8943,1355474,49319,2511256
2022/8/28,507709,671990,15649,2469416,56054,3720818
2022/8/29,496824,334026,7508,1096691,60239,1995288
2022/8/30,432092,586111,12872,1263741,66792,2361608
2022/8/31,410699,365611,6284,1000115,78076,1860785
2022/9/1,368400,305552,9663,884142,87235,1654992
2022/9/2,306516,485918,5329,984146,81530,1863439
2022/9/3,372241,518247,7794,1108167,59647,2066096
2022/9/4,491679,585055,13952,1356474,48224,2495384
2022/9/5,406436,194150,5427,836634,48712,1491359
2022/9/6,261506,292527,7960,724446,47723,1334162
2022/9/7,247032,261954,4956,668393,48253,1230588
2022/9/8,250703,273997,7879,691341,53044,1276964
2022/9/9,271694,474994,5567,920688,56413,1729356
2022/9/10,533732,706949,19393,1546795,55894,2862763
2022/9/11,797228,553738,10622,1754324,51664,3167576
2022/9/12,565086,759174,14095,1617989,53491,3009835
2022/9/13,415884,258559,5028,859936,60171,1599578
2022/9/14,246363,279042,7856,691553,79874,1304688
2022/9/15,241330,261472,4341,663284,118444,1288871
2022/9/16,245133,339724,8173,747579,149275,1489884
2022/9/17,351891,571568,7970,1130022,192047,2253498
2022/9/18,525808,439954,13496,1247770,202689,2429717
2022/9/19,411754,242289,4249,884775,219187,1762254
2022/9/20,219231,236809,7508,490323,53699,1007570
2022/9/21,213955,242313,3953,487104,58773,1006098
2022/9/22,219637,370621,35169,652675,62692,1340794
2022/9/23,405218,1505257,44687,2045809,65687,4066658
2022/9/24,473448,2659383,46059,3249356,59537,6487783
2022/9/25,608745,1935896,21976,2566617,59190,5192424
2022/9/26,424851,1640465,20242,2136701,64427,4286686
2022/9/27,224497,1445109,10014,1710604,69290,3459514
2022/9/28,219419,813778,8407,1070304,83387,2195295
2022/9/29,224821,947713,8610,1211651,83750,2476545
2022/9/30,250941,1140172,1765,1425808,75481,2894167
2022/10/1,575872,1342008,37463,2804804,63276,4823423
2022/10/2,843252,1328081,15254,2280136,56793,4523516
2022/10/3,688101,913359,13400,1686779,56616,3358255
2022/10/4,608872,800989,19955,1492947,58392,2981155
2022/10/5,534288,657873,10912,1258148,62420,2523641
2022/10/6,485337,616231,17129,1170430,69927,2359054
2022/10/7,454939,579400,9591,1093183,75454,2212567
2022/10/8,386873,402179,8026,840480,70340,1707898
2022/10/9,281351,326380,11361,653832,63923,1336847
2022/10/10,268154,320149,6134,627807,63733,1285977
2022/10/11,237388,282145,9246,1401539,64626,1994944
2022/10/12,235813,286304,5058,645578,68830,1241583
2022/10/13,238519,293109,5624,718530,78540,1334322
2022/10/14,247977,409498,3156,776378,86326,1523335
2022/10/15,364552,788667,1089,1429785,67332,2651425
2022/10/16,511812,389562,0,1192837,67202,2161413
2022/10/17,401136,333930,0,906975,62654,1704695
2022/10/18,249371,101423,0,487354,61684,899832
2022/10/19,243539,291609,1876,751216,65381,1353621
2022/10/20,243371,267910,0,628372,70436,1210089
2022/10/21,253415,420251,0,836870,72702,1583238
2022/10/22,374190,604911,3212,1193665,66538,2242516
2022/10/23,531917,474123,0,1416828,57901,2480769
2022/10/24,414860,272147,0,834252,55960,1577219
2022/10/25,265247,308600,0,1397338,55084,2026269
2022/10/26,265561,279714,95657,762626,60147,1463705
2022/10/27,274478,341809,9144,1479564,66247,2171242
2022/10/28,304917,492257,5847,1012975,71270,1887266
2022/10/29,472527,750460,18345,2360060,63844,3665236
2022/10/30,771861,552543,8123,1590665,54031,2977223
2022/10/31,475330,325419,5513,944810,52796,1803868
2022/11/1,291486,336491,8528,836477,55416,1528398
2022/11/2,282405,287996,4601,1829407,61755,2466164
2022/11/3,291213,312053,4802,1096578,69373,1774019
2022/11/4,298314,431110,8748,943201,77808,1759181
2022/11/5,442363,620073,7512,1963819,73083,3106850
2022/11/6,574101,496957,12352,1408503,63313,2555226
2022/11/7,436575,291900,4894,1572064,63591,2369024
2022/11/8,279338,297887,4791,755652,66029,1403697
2022/11/9,275371,301448,7582,701954,73344,1359699
2022/11/10,283214,333770,4486,825205,79246,1525921
2022/11/11,300160,412373,9239,911973,81602,1715347
2022/11/12,428689,654454,7760,1461354,78607,2630864
2022/11/13,598862,509615,7843,1317642,72851,2506813
2022/11/14,455413,302941,9316,1002259,75582,1845511
2022/11/15,279782,280131,4579,709100,81377,1354969
2022/11/16,259744,319982,7595,755400,88201,1430922
2022/11/17,267851,289908,4374,663693,95606,1321432
2022/11/18,276644,390402,4534,839156,96701,1607437
2022/11/19,408955,577618,12127,1384634,91977,2475311
2022/11/20,559756,567809,7051,1343097,90874,2568587
2022/11/21,443451,341773,9594,951135,85066,1831019
2022/11/22,312320,338273,5162,815827,86177,1557759
2022/11/23,313754,354675,8717,832195,90133,1599474
2022/11/24,311902,385033,4741,895031,95710,1692417
2022/11/25,334771,471781,5227,925501,100816,1838096
2022/11/26,446900,594986,12939,1926770,113392,3094987
2022/11/27,554683,481156,7203,1194589,165939,2403570
2022/11/28,466617,466364,9604,1123463,158312,2224360
2022/11/29,361525,398856,5120,983321,115966,1864788
2022/11/30,350657,378126,4944,923246,104133,1761106
2022/12/1,353307,408217,8335,1275468,98220,2143547
2022/12/2,374379,618233,4860,2080772,98118,3176362
2022/12/3,497012,689623,12196,1447703,95450,2741984
2022/12/4,576799,588673,6413,1364721,90115,2626721
2022/12/5,475940,476379,5297,1155401,89485,2202502
2022/12/6,352040,405473,7120,921982,98110,1784725
2022/12/7,305052,457697,4602,907852,102125,1777328
2022/12/8,375163,429137,4912,956310,107686,1873208
2022/12/9,352694,446456,8415,1046241,106225,1960031
2022/12/10,441429,734859,6879,1318987,94528,2596682
2022/12/11,543834,557002,11178,1310657,86170,2508841
2022/12/12,440098,420020,4397,1042481,84441,1991437
2022/12/13,326347,420250,4819,915732,80841,1747989
2022/12/14,331436,337647,7699,807653,83553,1567988
2022/12/15,339147,508742,4607,1001973,91264,1945733
2022/12/16,362466,472013,9272,1056224,92017,1991992
2022/12/17,464405,681710,6636,1480624,84166,2717541
2022/12/18,529080,598910,6428,1242928,84684,2462030
2022/12/19,458874,530518,10298,1284013,85732,2369435
2022/12/20,431494,548650,5395,1074681,83277,2143497
2022/12/21,445302,582712,9518,1420011,91845,2549388
2022/12/22,482300,536402,5992,1163898,108803,2297395
2022/12/23,472439,519309,5501,1216899,127442,2341590
2022/12/24,510074,725733,11268,1441477,159239,2847791
2022/12/25,521890,611286,5835,1378890,188401,2706302
2022/12/26,506031,563238,6609,1156735,98149,2330762
2022/12/27,463262,556569,10042,1089481,66358,2185712
2022/12/28,442823,525846,5363,1055450,70361,2099843
2022/12/29,437142,536540,2885,1328018,73936,2378521
2022/12/30,444474,572886,12387,1163157,76064,2268968
2022/12/31,495136,678403,6323,1478794,65680,2724336
2023/1/1,569005,112304,12293,822990,55722,1572314
2023/1/2,556957,1185753,5989,1749479,54802,3552980
2023/1/3,495977,770592,12780,1550743,56957,2887049
2023/1/4,678850,1965534,67133,103196606,64126,105972249
2023/1/5,514176,5271710,23788,5895855,68754,11774283
2023/1/6,487063,2638783,25010,3415732,69632,6636220
2023/1/7,506714,1712767,13577,2469333,64888,4767279
2023/1/8,515751,1352167,13106,2100566,54050,4035640
2023/1/9,510292,1172451,18429,2079915,53919,3835006
2023/1/10,502395,1102027,10813,1705927,54303,3375465
2023/1/11,506423,1090458,9693,1977075,62449,3646098
2023/1/12,511719,984742,15878,1643880,66341,3222560
2023/1/13,529918,929249,9877,1697974,67577,3234595
2023/1/14,579187,957973,16981,1712430,58482,3325053
2023/1/15,612348,886350,9456,1784743,53015,3345912
2023/1/16,587458,862599,10051,1789359,52925,3302392
2023/1/17,578162,848407,15600,1649941,52570,3144680
2023/1/18,620864,930076,9499,1976922,60781,3598142
2023/1/19,631339,852823,4016,1720772,65500,3274450
2023/1/20,644272,911440,21551,1844018,65450,3486731
2023/1/21,700376,1223079,11222,2247605,56272,4238554
2023/1/22,937878,1153162,19013,2843413,50618,5004084
2023/1/23,771952,1041488,9397,2135106,51284,4009227
2023/1/24,787576,986342,9034,2032713,53043,3868708
2023/1/25,702497,847133,15078,1777886,60170,3402764
2023/1/26,648466,813515,7996,1755949,67363,3293289
2023/1/27,605431,756672,13463,1499263,69565,2944394
2023/1/28,578461,734485,7764,1540206,68822,2929738
2023/1/29,537982,674296,7650,1553378,53254,2826560
2023/1/30,507588,634408,13132,1294192,52497,2501817
2023/1/31,480629,635472,7813,1427595,53405,2604914
2023/2/1,474212,636004,12643,1704451,59078,2886388
2023/2/2,464768,608852,7184,2233076,62853,3376733
2023/2/3,459874,579495,7363,1356946,67235,2470913
2023/2/4,466251,672091,13890,1262972,60979,2476183
2023/2/5,507860,617584,8211,1459047,53656,2646358
2023/2/6,476079,448151,6863,1083928,53149,2068170
2023/2/7,336133,395442,8975,918139,56509,1715198
2023/2/8,271072,351315,5101,738249,65582,1431319
2023/2/9,263935,355021,8222,722492,70602,1420272
2023/2/10,269171,474475,4771,962644,71892,1782953
2023/2/11,405499,683265,8370,1307013,65494,2469641
2023/2/12,549446,574452,13310,1394004,60096,2591308
2023/2/13,419236,568593,4689,1090316,55742,2138576
2023/2/14,229282,52572,7833,434600,57157,781444
2023/2/15,215312,304002,4005,624597,61456,1209372
2023/2/16,218331,310801,4377,721520,67143,1322172
2023/2/17,238120,472349,8300,879881,68842,1667492
2023/2/18,444075,831572,8244,1515631,66013,2865535
2023/2/19,642009,586197,7935,1502573,57335,2796049
2023/2/20,441798,301683,7985,844832,55534,1651832
2023/2/21,213119,273913,4146,615207,57321,1163706
2023/2/22,204907,285866,6760,617712,65343,1180588
2023/2/23,207822,284678,3438,633212,69091,1198241
2023/2/24,0,0,0,0,67001,67001
2023/2/25,622627,1239808,16959,2207320,59690,4146404
2023/2/26,578453,514408,7027,1260848,52993,2413729
2023/2/27,408337,286974,7377,910438,51534,1664660
2023/2/28,195927,268570,3785,572683,53596,1094561
2023/3/1,197512,241027,3995,442891,61056,946481
2023/3/2,198795,283350,6156,1414871,68372,1971544
2023/3/3,218366,481166,4012,796731,69581,1569856
2023/3/4,419120,731497,7664,1471733,67329,2697343
2023/3/5,596063,534351,11757,1372512,54767,2569450
2023/3/6,409089,268002,3689,912252,52665,1645697
2023/3/7,188780,230113,5871,525646,53384,1003794
2023/3/8,182268,263918,2957,563776,57210,1070129
2023/3/9,199107,250378,0,829131,59302,1337918
2023/3/10,193890,395310,6527,719389,66121,1381237
2023/3/11,356623,658355,6537,1198873,62836,2283224
2023/3/12,558178,535095,6608,1479024,57145,2636050
2023/3/13,396991,268301,6975,744351,53134,1469752
2023/3/14,187134,230744,3617,522822,54041,998358
2023/3/15,180470,227883,5466,550609,61859,1026287
2023/3/16,185316,256132,3032,544770,69681,1058931
2023/3/17,207884,397020,3747,717352,69981,1395984
2023/3/18,369301,677352,10500,1253425,62525,2373103
2023/3/19,551937,515006,6139,1406278,53211,2532571
2023/3/20,383096,253746,0,764373,54415,1455630
2023/3/21,180644,209199,9815,481836,56021,937515
2023/3/22,173160,247770,3408,537989,63244,1025571
2023/3/23,187121,243561,5176,580090,68276,1084224
2023/3/24,193714,382329,3281,645980,73065,1298369
2023/3/25,345212,624915,6236,1283643,69058,2329064
2023/3/26,541119,507301,9999,1252400,69482,2380301
2023/3/27,380009,266824,3427,1124491,73354,1848105
2023/3/28,219507,228939,5650,614847,75279,1144222
2023/3/29,181941,200185,2634,457771,82308,924839
2023/3/30,183430,248508,3234,524846,86752,1046770
2023/3/31,196390,379879,6204,741732,85268,1409473
2023/4/1,370852,670859,5980,1048042,85154,2180887
2023/4/2,562324,551003,9612,3365915,76065,4564919
2023/4/3,429965,314584,3455,873499,67426,1688929
2023/4/4,244817,426620,5045,789509,68197,1534188
2023/4/5,366646,561452,13355,1147782,74853,2164088
2023/4/6,451509,302039,4197,999196,84850,1841791
2023/4/7,223867,353382,4360,687001,103566,1372176
2023/4/8,321418,572272,9668,1081078,137922,2122358
2023/4/9,490313,483532,6039,1187193,172320,2339397
2023/4/10,366582,249062,6857,843310,221174,1686985
2023/4/11,180817,216082,3006,480377,64187,944469
2023/4/12,177620,245746,3515,518588,77673,1023142
2023/4/13,184911,251547,5726,549865,74905,1066954
2023/4/14,218804,410431,3496,810359,102942,1546032
2023/4/15,361406,868100,17027,1687182,56354,2990069
2023/4/16,826790,2004016,9688,3060319,50607,5951420
2023/4/17,479477,3187163,33295,3872088,50736,7622759
2023/4/18,217408,2539239,23701,2901297,51633,5733278
2023/4/19,204120,1324830,11269,1719410,55316,3314945
2023/4/20,203962,1018905,10281,1344912,59218,2637278
2023/4/21,221830,735725,14443,1567437,60606,2600041
2023/4/22,385655,982816,12497,1605849,56452,3043269
2023/4/23,489401,814839,14126,1584770,52034,2955170
2023/4/24,241607,647928,7303,897357,51221,1845416
2023/4/25,192706,508033,7766,995270,53784,1757559
2023/4/26,183380,345165,9498,607602,59066,1204711
2023/4/27,183880,340786,6094,603545,66688,1200993
2023/4/28,216822,580065,12309,1027643,67552,1904391
2023/4/29,478035,1020782,12026,1822855,77649,3411347
2023/4/30,751995,985271,11787,2247678,56862,4053593
2023/5/1,689345,950469,17973,1658623,61747,3378157
2023/5/2,628155,839840,9017,4234920,67047,5778979
2023/5/3,514350,717564,8521,1452791,74181,2767407
2023/5/4,390049,440670,9316,1049998,77600,1967633
2023/5/5,201330,386935,4914,729991,79337,1402507
2023/5/6,196808,468978,9394,778039,78199,1531418
2023/5/7,312522,604772,7608,1090157,77182,2092241
2023/5/8,398126,329636,5494,950131,80821,1764208
2023/5/9,181405,287938,7192,571071,80399,1128005
2023/5/10,174671,288584,4608,630636,82667,1181166
2023/5/11,178160,263424,8068,518513,85520,1053685
2023/5/12,184783,501820,4878,793851,132969,1618301
2023/5/13,337337,703293,13545,1373453,82621,2510249
2023/5/14,535679,615791,7512,1327028,91069,2577079
2023/5/15,396415,322931,5300,905868,93674,1724188
2023/5/16,186936,301004,6851,569089,97774,1161654
2023/5/17,182635,272015,4340,530454,95104,1084548
2023/5/18,187891,269368,6696,635483,95864,1195302
2023/5/19,198822,367936,4257,686901,96383,1354299
2023/5/20,336756,641272,11867,1213582,95748,2299225
2023/5/21,534135,535727,6934,1281594,97344,2455734
2023/5/22,404816,303480,4787,916270,100034,1729387
2023/5/23,189474,250373,6794,1170055,96380,1713076
2023/5/24,181745,241306,3745,505690,104344,1036830
2023/5/25,187835,270458,4086,588262,111771,1162412
2023/5/26,205671,407446,7115,846766,109394,1576392
2023/5/27,365305,682445,7016,1177751,108566,2341083
2023/5/28,565173,584837,11492,2185879,103417,3450798
2023/5/29,414455,310235,3818,802903,104180,1635591
2023/5/30,195734,275453,3913,578593,103464,1157157
2023/5/31,187412,267616,6197,1216894,103692,1781811
2023/6/1,204204,323410,4560,532507,100857,1165538
2023/6/2,260697,374993,5049,1306949,102552,2050240
2023/6/3,351556,598693,12064,1233142,102356,2297811
2023/6/4,529467,542550,7046,1283338,102610,2465011
2023/6/5,427366,339629,8829,938868,102948,1817640
2023/6/6,270688,337662,4439,733708,90664,1437161
2023/6/7,269858,326416,4791,101513145,82985,102197195
2023/6/8,257549,359907,7348,750909,77343,1453056
2023/6/9,306937,471578,4759,956731,78725,1818730
2023/6/10,429657,649983,7380,1409029,76530,2572579
2023/6/11,581409,570698,11332,1339362,81113,2583914
2023/6/12,446343,331584,4604,1034186,77669,1894386
2023/6/13,250210,296475,6865,639965,77157,1270672
2023/6/14,240618,289785,3763,751874,79269,1365309
2023/6/15,243288,301232,4142,648138,80518,1277318
2023/6/16,265688,408152,7483,1543059,78982,2303364
2023/6/17,376662,617549,6516,1214816,80592,2296135
2023/6/18,529777,563751,10863,2164329,84871,3353591
2023/6/19,446066,389388,4264,1067419,87795,1994932
2023/6/20,305686,385418,4711,815999,86013,1597827
2023/6/21,302796,484591,8183,961079,86847,1843496
2023/6/22,464446,882220,7861,1602918,92167,3049612
2023/6/23,732831,690126,6870,2654013,87767,4171607
2023/6/24,556854,550181,10242,1285776,87310,2490363
2023/6/25,439284,292359,4493,1707622,88126,2531884
2023/6/26,302123,374169,7634,916111,88445,1688482
2023/6/27,311236,773345,19472,1389428,85121,2578602
2023/6/28,542679,2038323,44415,2855361,89964,5570742
2023/6/29,478605,5816709,139697,6653200,94447,13182658
2023/6/30,472098,2638145,14198,3436154,102502,6663097
2023/7/1,557861,1815791,15713,2389879,103991,4883235
2023/7/2,613155,1380915,18352,3901370,105091,6018883
2023/7/3,541022,1167426,8898,1916763,100871,3734980
2023/7/4,456173,1094096,11931,1837568,101378,3501146
2023/7/5,451090,687258,7251,2168614,106375,3420588
2023/7/6,459900,689969,11277,1161698,113231,2436075
2023/7/7,465104,955854,7044,2803265,117717,4348984
2023/7/8,497368,562448,12472,1348919,121820,2543027
2023/7/9,531181,966029,7845,1732808,151657,3389520
2023/7/10,505814,632167,11015,1305060,237475,2691531
2023/7/11,468158,884292,6331,2503510,302708,4164999
2023/7/12,459962,641369,10317,1441043,74995,2627686
2023/7/13,474331,663445,5825,1315578,76953,2536132
2023/7/14,468356,498961,10361,2144622,77092,3199392
2023/7/15,478690,628994,6395,1329405,75231,2518715
2023/7/16,498195,652196,10940,1425606,74742,2661679
2023/7/17,492164,650824,6068,1345109,73719,2567884
2023/7/18,455614,670132,9746,1374573,73001,2583066
2023/7/19,447549,714439,5983,1323887,88769,2580627
2023/7/20,466680,557296,5903,2201497,92281,3323657
2023/7/21,471543,807656,9994,1613165,83614,2985972
2023/7/22,474796,385451,6345,1125374,78663,2070629
2023/7/23,489648,800359,6267,1553685,74488,2924447
2023/7/24,485801,663216,10054,1348373,74441,2581885
2023/7/25,447328,679715,5793,1353888,69082,2555806
2023/7/26,447088,632428,9659,1322861,68956,2480992
2023/7/27,466023,702525,5509,2384986,71643,3630686
2023/7/28,462197,616686,5693,1242876,72843,2400295
2023/7/29,496070,492931,10444,1228155,66469,2294069
2023/7/30,531784,720608,6380,2732253,61420,4052445
2023/7/31,518609,3671171,6156,4307048,64584,8567568
2023/8/1,484100,0,9585,494319,65648,1053652
2023/8/2,479889,588402,5583,2024823,66251,3164948
2023/8/3,465608,666497,9041,1370946,68396,2580488
2023/8/4,467028,0,5372,1792162,69138,2333700
2023/8/5,472872,804193,5858,1553289,65536,2901748
2023/8/6,507928,564725,9936,1288848,60090,2431527
2023/8/7,481150,520070,5248,1248801,57817,2313086
2023/8/8,448158,653669,5451,1270190,59099,2436567
2023/8/9,436339,485236,9317,1123310,65941,2120143
2023/8/10,435875,468021,5451,2264795,73989,3248131
2023/8/11,454871,668064,8457,1364319,77480,2573191
2023/8/12,460611,693658,5036,1421553,69533,2650391
2023/8/13,483888,707722,9037,1455745,60424,2716816
2023/8/14,468607,575107,4986,2389553,60005,3498258
2023/8/15,447566,567692,8382,1247414,65168,2336222
2023/8/16,445151,541867,4644,1177714,69559,2238935
2023/8/17,449949,516550,7874,1171072,79713,2225158
2023/8/18,451901,717806,4514,1428503,79394,2682118
2023/8/19,478791,809532,5397,2720975,68917,4083612
2023/8/20,565956,369190,8902,1266831,66941,2277820
2023/8/21,511373,891670,5109,1626985,56942,3092079
2023/8/22,471077,627914,8309,1256096,57371,2420767
2023/8/23,485403,583829,4733,1286982,62130,2423077
2023/8/24,450619,538879,7540,1258880,67933,2323851
2023/8/25,417707,44470,4344,748375,70647,1285543
2023/8/26,428173,0,7922,532868,67176,1036139
2023/8/27,465639,0,4787,814371,70216,1355013
2023/8/28,433202,2212144,7250,2792562,83263,5528421
2023/8/29,377541,451739,4046,1105847,94749,2033922
2023/8/30,371523,491398,6373,991283,91168,1951745
2023/8/31,353473,412080,16619,947590,102642,1832404
2023/9/1,349520,2230260,79405,2659884,101585,5420654
2023/9/2,358241,8184405,36818,9592041,80523,18252028
2023/9/3,458195,1749727,39770,2443357,56817,4747866
2023/9/4,358641,4508639,20596,4981837,54408,9924121
2023/9/5,191806,2891765,22117,4521641,54736,7682065
2023/9/6,181978,1237552,12358,1534610,58595,3025093
2023/9/7,181353,964097,16238,1301001,62419,2525108
2023/9/8,195500,993601,10659,1319436,65512,2584708
2023/9/9,344204,1200850,20793,1778154,67641,3411642
2023/9/10,512528,1102569,13888,101928504,67868,103625357
2023/9/11,382737,1079187,10677,1601773,64089,3138463
2023/9/12,187750,721359,12138,2321513,65538,3308298
2023/9/13,181547,655603,7712,950156,73744,1868762
2023/9/14,189160,388508,9890,692452,81310,1361320
2023/9/15,198907,476209,7331,845037,88497,1615981
2023/9/16,353996,902514,14963,1550156,79200,2900829
2023/9/17,540384,957795,10068,1791375,64801,3364423
2023/9/18,386111,733179,10085,1225522,65817,2420714
2023/9/19,182211,576157,5446,845724,74733,1684271
2023/9/20,184553,538508,12204,972507,93468,1801240
2023/9/21,310616,3832151,48390,4314851,117526,8623534
2023/9/22,230423,4368815,16772,4796405,154562,9566977
2023/9/23,358194,2573739,19658,3143623,197402,6292616
2023/9/24,530002,1660179,9869,2527968,280250,5008268
2023/9/25,378336,1209796,6936,1737074,322999,3655141
2023/9/26,177025,868681,7701,1200999,67966,2322372
2023/9/27,177326,475889,4469,771404,80730,1509818
2023/9/28,215343,776110,4861,1188619,90261,2275194
2023/9/29,514533,1139674,13652,2246680,91777,4006316
2023/9/30,893004,1252297,7644,2449086,83708,4685739
2023/10/1,682378,1117645,11108,1815825,75456,3702412
2023/10/2,606466,1090070,6406,3197577,62532,4963051
2023/10/3,535562,948802,6292,1871909,62141,3424706
2023/10/4,487098,801157,9322,1532928,65375,2895880
2023/10/5,445541,762414,5362,1346113,65854,2625284
2023/10/6,399922,637486,5227,1285901,75912,2404448
2023/10/7,310775,375219,6591,774260,66945,1533790
2023/10/8,172044,329889,3699,643554,52955,1202141
2023/10/9,161994,271663,5599,574482,56603,1070341
2023/10/10,151471,251592,3366,450785,58926,916140
2023/10/11,148690,353963,3482,506641,64425,1077201
2023/10/12,152172,274979,5349,665102,72607,1170209
2023/10/13,162566,447171,3175,771304,80737,1464953
2023/10/14,294955,626095,5518,1125575,78229,2130372
2023/10/15,459133,497417,8850,1127608,60106,2153114
2023/10/16,329094,329678,3664,849032,59071,1570539
2023/10/17,164819,254914,5247,523457,63189,1011626
2023/10/18,162074,270490,2910,543534,66569,1045577
2023/10/19,166922,243077,3084,535701,71274,1020058
2023/10/20,193436,393193,5631,740310,80253,1412823
2023/10/21,338393,599405,4758,1205166,76284,2224006
2023/10/22,491218,455531,4793,1194327,64836,2210705
2023/10/23,349461,229233,5235,703685,64659,1352273
2023/10/24,162435,225637,2890,464952,68469,924383
2023/10/25,158404,211006,4910,471334,73552,919206
2023/10/26,166255,228481,2683,544839,82965,1025223
2023/10/27,180162,335292,2973,665848,90810,1275085
2023/10/28,319277,638401,7810,1148320,108809,2222617
2023/10/29,547652,502275,4662,1428535,73362,2556486
2023/10/30,374998,243189,3234,691072,63475,1375968
2023/10/31,180442,223666,4579,550787,68141,1027615
2023/11/1,175474,219645,2867,398307,69788,866081
2023/11/2,181494,223811,3102,1441732,76713,1926852
2023/11/3,191861,379683,5161,741796,82048,1400549
2023/11/4,353363,586419,4736,1130185,78426,2153129
2023/11/5,519439,486785,7747,1404362,77040,2495373
2023/11/6,374444,243944,2752,805964,75732,1502836
2023/11/7,183153,218528,2800,465148,81722,951351
2023/11/8,167987,217480,4387,508679,82332,980865
2023/11/9,167186,203617,2402,493876,83108,950189
2023/11/10,177389,319923,2841,655383,85613,1241149
2023/11/11,301294,523456,6767,1125045,88683,2045245
2023/11/12,472239,439226,4335,1128733,92669,2137202
2023/11/13,339589,227918,5266,676958,97311,1347042
2023/11/14,164975,210280,2351,561591,97855,1037052
2023/11/15,159910,197487,2399,423400,105618,888814
2023/11/16,165117,175041,4106,466701,110423,921388
2023/11/17,175184,351487,2481,662496,113848,1305496
2023/11/18,312912,537945,4256,1133277,104158,2092548
2023/11/19,471849,433916,6621,1200321,98796,2211503
2023/11/20,338447,193861,2735,595202,90953,1221198
2023/11/21,167703,192184,2643,484971,95628,943129
2023/11/22,168386,125345,3933,417935,93139,808738
2023/11/23,173462,174176,2666,454573,91484,896361
2023/11/24,187882,320348,4639,663119,83724,1259712
2023/11/25,305719,397901,3915,937398,81857,1726790
2023/11/26,469902,619223,4191,1382463,89239,2565018
2023/11/27,335429,160623,4895,632334,91035,1224316
2023/11/28,168248,283304,2291,565445,94305,1113593
2023/11/29,164330,143190,4069,410027,90151,811767
2023/11/30,170907,181155,2088,488691,129755,972596
2023/12/1,201033,368421,2542,572474,130425,1274895
2023/12/2,351175,436915,6314,1886867,130264,2811535
2023/12/3,498274,647243,3976,1511251,129969,2790713
2023/12/4,346277,160939,4473,572162,94394,1178245
2023/12/5,171337,288773,2275,586323,59364,1108072
2023/12/6,164611,159545,4963,444815,137515,911449
2023/12/7,173231,193402,3235,538896,137615,1046379
2023/12/8,183442,335698,5107,633024,137302,1294573
2023/12/9,306776,419416,4371,995164,137841,1863568
2023/12/10,474140,641487,6922,1379482,137890,2639921
2023/12/11,351686,181050,2849,648041,130058,1313684
2023/12/12,184207,319554,4442,630344,137541,1276088
2023/12/13,171718,216586,2622,547243,137139,1075308
2023/12/14,196675,243323,4521,570933,137237,1152689
2023/12/15,236316,437372,2649,810033,136390,1622760
2023/12/16,370097,441039,6739,1086315,138072,2042262
2023/12/17,494753,666046,3585,1389928,137165,2691477
2023/12/18,341352,183144,4316,705990,192602,1427404
2023/12/19,178760,304164,2073,574938,130465,1190400
2023/12/20,174488,146204,3862,481568,130114,936236
2023/12/21,180224,181182,1882,441841,129895,935024
2023/12/22,185012,339183,4498,727423,53183,1309299
2023/12/23,319823,395807,3366,933908,59423,1712327
2023/12/24,458275,626507,6130,1320962,59341,2471215
2023/12/25,350578,179924,2236,682858,59500,1275096
2023/12/26,179878,299751,0,605761,59332,1144722
2023/12/27,178516,149377,6880,489915,133550,958238
2023/12/28,186241,200427,2375,1917516,133736,2440295
2023/12/29,217258,454762,4159,807057,133206,1616442
2023/12/30,433398,518602,3957,1198325,133918,2288200
2023/12/31,653782,942809,7334,2069823,133827,3807575
2024/1/1,612187,473514,3680,1090483,109911,2289775
2024/1/2,446038,399328,4094,2108330,110314,3068104
2024/1/3,212419,158311,2047,552733,110634,1036144
2024/1/4,201599,222631,20295,598255,110214,1152994
2024/1/5,332656,1828154,34353,2365232,109901,4670296
2024/1/6,393952,2513105,28460,3126384,109745,6171646
2024/1/7,534216,2284823,13750,3123206,119126,6075121
2024/1/8,404004,1521772,14506,2185393,108313,4233988
2024/1/9,243697,1390717,7764,1771038,108223,3521439
2024/1/10,234224,803419,9581,1222963,107536,2377723
2024/1/11,245359,674084,5262,1028015,131632,2084352
2024/1/12,260962,831408,8664,1269778,113046,2483858
2024/1/13,393319,954627,6194,1730367,110668,3195175
2024/1/14,536941,1153816,9690,1916572,108492,3725511
2024/1/15,415702,781691,4178,1323120,132056,2656747
2024/1/16,269684,950094,6959,1443317,107102,2777156
2024/1/17,278257,586862,3844,1007322,106917,1983202
2024/1/18,305693,666080,18651,1188176,112361,2290961
2024/1/19,376019,1584493,58850,2213201,112400,4344963
2024/1/20,476070,3582174,40870,4458254,109455,8666823
2024/1/21,554532,3875741,43292,104677073,109903,109260541
2024/1/22,493590,3541442,25178,4384497,132014,8576721
2024/1/23,386307,2723511,23872,3361970,106705,6602365
2024/1/24,395066,1526814,0,2057169,109892,4088941
2024/1/25,433569,1220542,32950,1894977,109621,3691659
2024/1/26,487451,1334858,8400,2241803,108544,4181056
2024/1/27,537380,846295,12739,1533725,109871,3040010
2024/1/28,574003,1293530,7078,2295883,98990,4269484
2024/1/29,548497,963756,6717,1726898,107513,3353381
2024/1/30,528827,1330748,10225,2182572,81973,4134345
2024/1/31,542237,853677,6047,1655381,108745,3166087
2024/2/1,604135,829284,6125,1440753,108281,2988578
2024/2/2,622564,1269320,9976,4453685,111634,6467179
2024/2/3,639397,772413,5625,1703984,115481,3236900
2024/2/4,636903,1280974,9560,2449232,112915,4489584
2024/2/5,623493,745244,5203,1520081,142101,3036122
2024/2/6,627815,1281915,5260,2465418,116287,4496695
2024/2/7,694151,788616,9687,1816616,116258,3425328
2024/2/8,705937,762935,5177,1701541,115458,3291048
2024/2/9,694548,1355547,5941,2680682,115617,4852335
2024/2/10,861152,950373,10332,2231890,116372,4170119
2024/2/11,722683,1369624,4664,2476253,115839,4689063
2024/2/12,729405,765800,4695,1871757,115881,3487538
2024/2/13,666136,1177916,7297,2172946,116346,4140641
2024/2/14,640020,683625,4279,1603050,115953,3046927
2024/2/15,623292,662611,7514,1600389,116506,3010312
2024/2/16,600858,1061070,4087,1974461,115665,3756141
2024/2/17,558953,592172,3952,1497928,116301,2769306
2024/2/18,535156,983792,7078,1676028,112933,3314987
2024/2/19,515093,581186,3865,1365317,113531,2578992
2024/2/20,495907,830268,3928,1566006,149495,3045604
2024/2/21,475252,467096,6668,1195443,116042,2260501
2024/2/22,462450,453842,3468,1100581,116472,2136813
2024/2/23,448817,815118,6806,1505734,116132,2892607
2024/2/24,487804,536270,4026,1302600,116227,2446927
2024/2/25,531259,813284,3619,1570068,112962,3031192
2024/2/26,399895,274956,5137,843204,111262,1634454
2024/2/27,253156,466274,2195,911233,131669,1764527
2024/2/28,230146,209316,2452,530824,113472,1086210
2024/2/29,226277,242487,4336,676566,112682,1262348
2024/3/1,236456,478123,2459,717681,113749,1548468
2024/3/2,382169,501924,4088,2080943,115918,3085042
2024/3/3,556898,784642,7061,1680906,112929,3142436
2024/3/4,410984,197000,2449,752794,109945,1473172
2024/3/5,214892,432159,4648,770950,138353,1561002
2024/3/6,212463,191687,2081,537268,116447,1059946
2024/3/7,213263,227234,2566,564572,116083,1123718
2024/3/8,230149,513510,4997,901336,112412,1762404
2024/3/9,445965,567382,3978,1310900,113343,2441568
2024/3/10,630221,848003,3998,1824143,111271,3417636
2024/3/11,446493,196969,4634,780886,87147,1516129
2024/3/12,218508,241802,2173,574603,120636,1157722
2024/3/13,208136,314827,4313,680316,112823,1320415
2024/3/14,211095,207044,1755,550995,111273,1082162
2024/3/15,216312,448268,2315,820220,113320,1600435
2024/3/16,393153,521544,6958,1224003,113306,2258964
2024/3/17,598283,796339,3627,1585608,105484,3089341
2024/3/18,435817,181509,2501,823888,111041,1554756
2024/3/19,211178,219609,3714,589041,97617,1121159
2024/3/20,210654,306885,1918,613878,115758,1249093
2024/3/21,203773,200694,2218,573017,110254,1089956
2024/3/22,227075,459658,4097,855720,93222,1639772
2024/3/23,403999,544146,3944,1227305,92896,2272290
2024/3/24,627437,821314,6510,1785337,110940,3351538
2024/3/25,450223,188439,1879,738288,111292,1490121
2024/3/26,215482,220775,2099,578371,111126,1127853
2024/3/27,197891,303592,3742,606028,109983,1221236
2024/3/28,205422,277453,14090,696385,109582,1302932
2024/3/29,337672,1718999,34314,2272423,111370,4474778
2024/3/30,420623,1708886,30984,2592532,111766,4864791
2024/3/31,601960,2323754,16229,3168061,111545,6221549
2024/4/1,450811,2200577,16233,2667621,113268,5448510
2024/4/2,228980,1905496,8886,3271615,109626,5524603
2024/4/3,244099,1409072,7988,1787148,79665,3527972
2024/4/4,507943,1422180,15280,2243277,78239,4266919
2024/4/5,753081,1370319,8003,2630461,93395,4855259
2024/4/6,597062,826416,7504,1605911,100560,3137453
2024/4/7,432995,922856,8653,1606108,110505,3081117
2024/4/8,220976,753171,4598,1087722,112435,2178902
2024/4/9,197073,586178,4549,883494,109812,1781106
2024/4/10,198504,618904,6515,983122,110395,1917440
2024/4/11,226979,405036,4137,738648,111932,1486732
2024/4/12,243114,646729,6820,1089920,111717,2098300
2024/4/13,346783,568113,5086,1164649,94434,2179065
2024/4/14,526206,852127,5135,1601703,98834,3084005
2024/4/15,410327,337306,6101,953977,122090,1829801
2024/4/16,201417,321950,3083,621041,113057,1260548
2024/4/17,198071,378850,3295,747006,112806,1440028
2024/4/18,203325,260304,5037,589942,112495,1171103
2024/4/19,215821,520269,3258,844659,116211,1700218
2024/4/20,371909,537806,8324,1258947,113455,2290441
2024/4/21,569405,812439,4630,1635314,112804,3134592
2024/4/22,423130,259559,3252,872002,100476,1658419
2024/4/23,204148,266535,4919,593720,103577,1172899
2024/4/24,198393,364742,2536,42511314,118199,43195184
2024/4/25,196371,220577,4567,618143,115726,1155384
2024/4/26,211656,472941,2481,839735,113343,1640156
2024/4/27,345966,465438,6641,1214932,142373,2175350
2024/4/28,457778,304443,2552,929749,116818,1811340
2024/4/29,239713,383409,5177,783179,113371,1524849
2024/4/30,272582,298701,3209,888437,113329,1576258
2024/5/1,548123,1193156,10016,1809460,115767,3676522
2024/5/2,810701,665244,5024,5057947,116229,6655145
2024/5/3,677056,1007692,8349,1980963,112832,3786892
2024/5/4,616965,568902,4377,1536940,112029,2839213
2024/5/5,575224,550666,4313,1534258,83963,2748424
2024/5/6,446785,528972,5332,1193709,115680,2290478
2024/5/7,220157,276164,2939,717083,109670,1326013
2024/5/8,204119,382872,4189,703269,114136,1408585
2024/5/9,201653,197244,2555,550016,109848,1061316
2024/5/10,200619,381184,4300,797846,109950,1493899
2024/5/11,223064,254152,2752,630146,111179,1221293
2024/5/12,376040,549362,6545,1363982,76232,2372161
2024/5/13,452672,475241,2524,1117651,93235,2141323
2024/5/14,203152,233693,4205,551917,94588,1087555
2024/5/15,202866,364716,2311,820760,111871,1502524
2024/5/16,203573,192599,4365,539263,110476,1050276
2024/5/17,219576,511328,2405,992874,111987,1838170
2024/5/18,377057,537208,7106,1223943,111305,2256619
2024/5/19,592692,519490,3888,1401014,109566,2626650
2024/5/20,449646,456683,4797,1232509,97634,2241269
2024/5/21,215311,196962,2286,543084,113270,1070913
2024/5/22,205769,367677,4997,740301,112914,1431658
2024/5/23,213138,169568,2250,600628,113288,1098872
2024/5/24,221861,226667,5315,612158,111588,1177589
2024/5/25,354127,787285,4004,1526400,96584,2768400
2024/5/26,568074,512465,6740,1438257,93593,2619129
2024/5/27,436548,449558,2210,1121673,95017,2105006
2024/5/28,211574,214903,2551,665474,110242,1204744
2024/5/29,203645,354261,4012,759305,120913,1442136
2024/5/30,209898,184170,2558,656181,112644,1165451
2024/5/31,233385,256780,4298,674390,112912,1281765
2024/6/1,389312,833122,3937,101318846,112946,102658163
2024/6/2,581999,500095,6825,3793860,113021,4995800
2024/6/3,435045,438211,2530,1119145,109584,2104515
2024/6/4,219327,202353,4274,648910,97686,1172550
2024/6/5,227339,421311,2402,863116,125563,1639731
2024/6/6,270383,248031,4661,722941,113188,1359204
2024/6/7,290452,297196,2506,947295,112861,1650310
2024/6/8,433398,927358,7270,1662447,113316,3143789
2024/6/9,658267,611367,4136,1871490,111652,3256912
2024/6/10,709353,1050227,7507,2130933,99297,3997317
2024/6/11,609680,177421,2324,1100708,130911,2021044
2024/6/12,289702,0,4531,574794,141439,1010466
2024/6/13,267077,230898,2333,657622,112630,1270560
2024/6/14,271476,268470,5352,835706,113238,1494242
2024/6/15,375299,794538,3785,1485601,111974,2771197
2024/6/16,561876,514060,6959,1347900,97497,2528292
2024/6/17,487381,547144,2422,1401385,109605,2547937
2024/6/18,305107,248762,5174,723974,111491,1394508
2024/6/19,306294,314447,2622,816705,126377,1566445
2024/6/20,310895,462154,2988,1109753,112891,1998681
2024/6/21,332095,313383,5174,862932,112596,1626180
2024/6/22,434847,832265,4115,1605705,113338,2990270
2024/6/23,574871,489580,6781,1405492,113172,2589896
2024/6/24,494344,564336,2736,1364552,144570,2570538
2024/6/25,331339,256532,4661,935074,101697,1629303
2024/6/26,312217,299713,2641,822513,102598,1539682
2024/6/27,342072,632182,24758,1303217,77797,2380026
2024/6/28,577134,1912925,44516,2940711,95639,5570925
2024/6/29,558385,3486634,34969,4471615,78453,8630056
2024/6/30,622299,2541109,18942,3742903,93366,7018619
2024/7/1,534038,2425113,20640,3079452,86729,6145972
2024/7/2,415805,1507317,10322,3339207,111233,5383884
2024/7/3,419710,1237788,13214,1943700,101824,3716236
2024/7/4,435498,1317586,7692,2176044,93373,4030193
2024/7/5,459241,346712,11346,1090414,100291,2008004
2024/7/6,516321,1896266,7366,2706720,76376,5203049
2024/7/7,578740,0,11482,1159603,93622,1843447
2024/7/8,530626,2560955,6287,3354247,84127,6536242
2024/7/9,458999,668201,9264,1399084,48595,2584143
2024/7/10,448090,635455,5222,1503334,52587,2644688
2024/7/11,463228,944668,9223,1713612,107360,3238091
2024/7/12,494613,621148,5132,1328631,85276,2534800
2024/7/13,487337,975519,5347,1863977,111884,3444064
2024/7/14,509179,619927,8585,1418198,92153,2648042
2024/7/15,500391,0,4986,708672,102270,1316319
2024/7/16,461437,1754411,7742,2617270,82286,4923146
2024/7/17,455562,518625,4525,1205318,111728,2295758
2024/7/18,454964,625909,8450,1400491,89748,2579562
2024/7/19,553467,527864,4970,1397217,111377,2594895
2024/7/20,493181,830860,8535,1610895,112839,3056310
2024/7/21,495280,524610,5422,1402612,150711,2578635
2024/7/22,486581,494415,4890,1249083,110312,2345281
2024/7/23,448143,773822,7040,1501196,109951,2840152
2024/7/24,439229,466746,3857,1186827,106919,2203578
2024/7/25,434093,746295,7632,1426521,111577,2726118
2024/7/26,435634,436999,4143,1182485,111283,2170544
2024/7/27,445294,770068,4527,1504903,109978,2834770
2024/7/28,466014,476694,7938,1216376,112945,2279967
2024/7/29,472115,467941,3950,1281797,112874,2338677
2024/7/30,435909,756852,3891,1418085,110138,2724875
2024/7/31,423274,434608,6574,1136318,111973,2112747
2024/8/1,416602,712867,3796,1169987,96884,2400136
2024/8/2,420455,414651,3668,2683808,109823,3632405
2024/8/3,426854,731075,6680,1393378,81309,2639296
2024/8/4,443648,447810,3989,1142930,41911,2080288
2024/8/5,445545,428614,6451,1267910,43711,2192231
2024/8/6,418688,662886,3289,1296116,109711,2490690
2024/8/7,420036,440899,3504,1086983,127399,2078821
2024/8/8,419826,0,0,594551,115778,1130155
2024/8/9,440596,787094,0,1486098,116080,2829868
2024/8/10,446707,0,0,719267,116681,1282655
2024/8/11,475327,0,0,767129,115767,1358223
2024/8/12,460593,1730718,0,2470740,112668,4774719
2024/8/13,426578,0,0,678471,112894,1217943
2024/8/14,418520,0,0,676846,113015,1208381
2024/8/15,414701,0,0,666217,111928,1192846
2024/8/16,422176,2454819,0,3128877,97566,6103438
2024/8/17,0,0,0,263188,87739,350927
2024/8/18,884858,0,0,1176446,106924,2168228
2024/8/19,445472,0,0,721552,90556,1257580
2024/8/20,414754,0,0,476433,98602,989789
2024/8/21,406248,2540332,0,3390270,99906,6436756
2024/8/22,402101,0,0,640725,91920,1134746
2024/8/23,417610,0,0,680084,81930,1179624
2024/8/24,432698,0,0,704293,108761,1245752
2024/8/25,445942,2565803,0,788302356,108406,791422507
2024/8/26,427967,0,0,701715,108730,1238412
2024/8/27,397076,0,94384,520334,90588,1102382
2024/8/28,382923,1476011,0,2107496,108809,4075239
2024/8/29,384621,404695,0,786091563,108681,786989560
2024/8/30,396182,422627,0,849086,108288,1776183
2024/8/31,0,473712,0,785765927,90821,786330460
2024/9/1,0,446391,0,477920,108151,1032462
2024/9/2,1155245,325572,25714,3424267,99001,5029799
2024/9/3,201657,253822,2992,786163690,45482,786667643
2024/9/4,196718,362930,2416,580542,84484,1227090
2024/9/5,199917,180884,3185,785949896,94230,786428112
2024/9/6,214670,215668,2771,737176,91317,1261602
2024/9/7,328101,691671,4958,1247240,74581,2346551
2024/9/8,472036,453685,4318,974249,47084,1951372
2024/9/9,366439,274858,2719,786369459,46142,787059617
2024/9/10,193086,250602,1513,469313,48732,963246
2024/9/11,187016,191399,3225,515522,42529,939691
2024/9/12,177218,283801,2470,786033262,58927,786555678
2024/9/13,184992,185904,2644,399960,45301,818801
2024/9/14,194779,498030,4742,725794,75127,1498472
2024/9/15,389501,555183,4706,1274046,47631,2271067
2024/9/16,0,589876,2740,1012927,74942,1680485
2024/9/17,0,633718,3845,786477098,46788,787161449
2024/9/18,1730637,448421,5917,2240715,65741,4491431
2024/9/19,199253,232185,2565,905384,48466,1387853
2024/9/20,180910,231400,3112,444208,58505,918135
2024/9/21,280660,567445,3762,1111207,51989,2015063
2024/9/22,444946,533016,3759,786770096,83296,787835113
2024/9/23,350610,111511,2988,499320,100250,1064679
2024/9/24,170912,207214,2077,401476,107157,888836
2024/9/25,168087,218037,2933,411227,92060,892344
2024/9/26,320981,0,15188,383205,109091,828465
2024/9/27,237479,0,45975,312877,75034,671365
2024/9/28,336115,0,25346,396517,44021,801999
2024/9/29,424141,0,17844,482570,80460,1005015
2024/9/30,265755,0,17345,310603,108429,702132
2024/10/1,0,0,15203,60473,108583,184259
2024/10/2,545804,0,12791,620303,102604,1281502
2024/10/3,0,0,10952,61045,58790,130787
2024/10/4,0,0,7906,52051,39183,99140
2024/10/5,0,0,10986,51938,45286,108210
2024/10/6,2904826,0,6562,2948900,75108,5935396
2024/10/7,0,0,0,36036,73238,109274
2024/10/8,766129,0,18158,813218,38573,1636078
2024/10/9,168084,0,5903,193078,69557,436622
2024/10/10,0,0,4566,26919,42455,73940
2024/10/11,327254,0,4678,353475,36789,722196
2024/10/12,188908,0,4571,216522,33300,443301
2024/10/13,315422,0,5558,352502,31297,704779
2024/10/14,390016,0,3756,431201,32996,857969
2024/10/15,183580,0,4481,209551,50816,448428
2024/10/16,190320,0,3979,219499,44257,458055
2024/10/17,198027,0,4055,226465,38633,467180
2024/10/18,242909,0,4170,272520,41509,561108
2024/10/19,0,0,3543,38817,43101,85461
2024/10/20,999807,0,7077,1063454,48152,2118490
2024/10/21,433774,0,3579,483539,75718,996610
2024/10/22,207134,0,4592,239203,106406,557335
2024/10/23,193879,0,3457,225565,108177,531078
2024/10/24,188951,0,2348,218058,106758,516115
2024/10/25,197415,0,5181,230431,107327,540354
2024/10/26,341705,0,5289,382469,50223,779686
2024/10/27,0,0,4086,4086,48053,56225
2024/10/28,1068159,0,4431,1160965,74458,2308013
2024/10/29,0,0,3180,81378,107241,191799
2024/10/30,399841,0,2835,432478,107569,942723
2024/10/31,201636,0,3916,233060,96226,534838
2024/11/1,233920,0,3022,265526,91252,593720
2024/11/2,400014,0,6088,406102,74632,886836
2024/11/3,0,0,4504,42019,106750,153273
2024/11/4,0,0,923,53871,106915,161709
2024/11/5,0,0,0,72298,91302,163600
2024/11/6,0,0,0,29289,89226,118515
2024/11/7,1551988,0,10262,1657084,78947,3298281
2024/11/8,197170,0,3533,229159,57175,487037
2024/11/9,317609,0,3787,1773510,52921,2147827
2024/11/10,501591,0,4911,625809,45248,1177559
2024/11/11,377007,0,2001,425243,84748,888999
2024/11/12,185685,0,2724,100217019,42446,100447874
2024/11/13,186347,0,4172,220222,66086,476827
2024/11/14,192999,0,2592,292501,51350,539442
2024/11/15,207736,0,3003,239613,68605,518957
2024/11/16,387400,0,4686,432671,45375,870132
2024/11/17,575927,0,4152,707570,42697,1330346
2024/11/18,406754,0,1949,454953,45957,909613
2024/11/19,193554,0,3573,294987,56924,549038
2024/11/20,185011,0,3547,216784,47277,452619
2024/11/21,186740,0,2526,216286,42523,448075
2024/11/22,189649,0,2173,220201,42700,454723
2024/11/23,308538,0,4905,351020,44866,709329
2024/11/24,490400,0,3529,546129,58508,1098566
2024/11/25,367618,0,2225,485202,59248,914293
2024/11/26,190269,0,2602,222044,42427,457342
2024/11/27,178642,0,1767,208647,42606,431662
2024/11/28,180168,0,3226,210519,40755,434668
2024/11/29,208808,0,3206,311876,45868,569758
2024/11/30,350418,0,2051,390372,41226,784067
2024/12/1,535059,0,6259,595880,42438,1179636
2024/12/2,384796,0,3328,432396,50460,870980
2024/12/3,187415,0,2269,290934,50642,531260
2024/12/4,177925,0,1280,207953,50909,438067
2024/12/5,178845,0,3295,209718,62999,454857
2024/12/6,185659,0,2991,215224,62820,466694
2024/12/7,313054,0,3167,350909,54358,721488
2024/12/8,482089,0,3836,534933,50835,1071693
2024/12/9,350539,0,1146,465526,42587,859798
2024/12/10,175613,0,3201,202635,50594,432043
2024/12/11,173075,0,2259,200791,42636,418761
2024/12/12,175407,0,2166,279845,42327,499745
2024/12/13,185608,0,2392,217413,41893,447306
2024/12/14,318022,0,1787,360489,75136,755434
2024/12/15,492710,0,5196,548443,66583,1112932
2024/12/16,351905,0,837,391264,74669,818675
2024/12/17,173944,0,3546,201975,74628,454093
2024/12/18,171683,0,2125,199053,72727,445588
2024/12/19,178178,0,1682,206845,98266,484971
2024/12/20,183059,0,3223,219816,90832,496930
2024/12/21,303353,0,2633,341178,87828,734992
2024/12/22,486287,0,4022,543792,107158,1141259
2024/12/23,377021,0,2078,424141,71672,874912
2024/12/24,193737,0,2716,228245,42462,467160
2024/12/25,185455,0,27014,243530,40727,496726
2024/12/26,363095,0,34351,476905,32061,906412
2024/12/27,261492,0,22041,326877,37409,647819
2024/12/28,402159,0,18362,470710,42446,933677
2024/12/29,542505,0,12806,615163,42397,1212871
2024/12/30,402695,0,12084,462110,42719,919608
2024/12/31,247774,0,7734,288720,42368,586596
